,id,release_date,movie,production_budget,domestic_gross,worldwide_gross,worldwide_profitability,worldwide_ROI,domestic_profitability,domestic_ROI,title_id,ordering,region,language
0,1,"Dec 18, 2009",Avatar,425000000,760507625,2776345279,2351345279,553.2577127058823,335507625,78.9429705882353,tt1775309,2,XWW,en
1,2,"May 20, 2011",Pirates of the Caribbean: On Stranger Tides,410600000,241063875,1045663875,635063875,154.6672856794934,-169536125,-41.28985021919143,tt1298650,23,CA,en
2,3,"Jun 7, 2019",Dark Phoenix,350000000,42762350,149762350,-200237650,-57.21075714285714,-307237650,-87.7821857142857,tt6565702,1,BD,en
6,7,"Apr 27, 2018",Avengers: Infinity War,300000000,678815482,2048134200,1748134200,582.7114,378815482,126.27182733333333,tt4154756,13,XWW,en
6,7,"Apr 27, 2018",Avengers: Infinity War,300000000,678815482,2048134200,1748134200,582.7114,378815482,126.27182733333333,tt4154756,14,US,en
6,7,"Apr 27, 2018",Avengers: Infinity War,300000000,678815482,2048134200,1748134200,582.7114,378815482,126.27182733333333,tt4154756,31,IN,en
8,9,"Nov 17, 2017",Justice League,300000000,229024295,655945209,355945209,118.64840299999999,-70975705,-23.65856833333333,tt0974015,16,IT,it
8,9,"Nov 17, 2017",Justice League,300000000,229024295,655945209,355945209,118.64840299999999,-70975705,-23.65856833333333,tt0974015,33,FR,fr
9,10,"Nov 6, 2015",Spectre,300000000,200074175,879620923,579620923,193.20697433333333,-99925825,-33.30860833333333,tt2379713,16,XWW,en
9,10,"Nov 6, 2015",Spectre,300000000,200074175,879620923,579620923,193.20697433333333,-99925825,-33.30860833333333,tt2379713,23,TR,tr
9,10,"Nov 6, 2015",Spectre,300000000,200074175,879620923,579620923,193.20697433333333,-99925825,-33.30860833333333,tt2379713,26,CA,fr
9,10,"Nov 6, 2015",Spectre,300000000,200074175,879620923,579620923,193.20697433333333,-99925825,-33.30860833333333,tt2379713,31,IL,he
10,11,"Jul 20, 2012",The Dark Knight Rises,275000000,448139099,1084439099,809439099,294.3414905454545,173139099,62.959672363636365,tt1345836,23,HK,en
10,11,"Jul 20, 2012",The Dark Knight Rises,275000000,448139099,1084439099,809439099,294.3414905454545,173139099,62.959672363636365,tt1345836,24,CA,en
13,14,"Mar 9, 2012",John Carter,275000000,73058679,282778100,7778100,2.8284,-201941321,-73.43320763636363,tt0401729,32,IL,he
13,14,"Mar 9, 2012",John Carter,275000000,73058679,282778100,7778100,2.8284,-201941321,-73.43320763636363,tt0401729,4,CA,fr
16,17,"May 6, 2016",Captain America: Civil War,250000000,408084349,1140069413,890069413,356.0277652,158084349,63.23373960000001,tt3498820,24,CA,en
16,17,"May 6, 2016",Captain America: Civil War,250000000,408084349,1140069413,890069413,356.0277652,158084349,63.23373960000001,tt3498820,7,TH,en
17,18,"Mar 25, 2016",Batman v Superman: Dawn of Justice,250000000,330360194,867500281,617500281,247.0001124,80360194,32.144077599999996,tt2975590,15,CA,en
18,19,"Dec 14, 2012",The Hobbit: An Unexpected Journey,250000000,303003568,1017003568,767003568,306.80142720000003,53003568,21.2014272,tt0903624,8,CA,en
20,21,"Dec 13, 2013",The Hobbit: The Desolation of Smaug,250000000,258366855,960366855,710366855,284.14674199999996,8366855,3.346742,tt1170358,42,CA,en
21,22,"Dec 17, 2014",The Hobbit: The Battle of the Five Armies,250000000,255119788,945577621,695577621,278.23104839999996,5119788,2.0479152000000003,tt2310332,26,CA,en
21,22,"Dec 17, 2014",The Hobbit: The Battle of the Five Armies,250000000,255119788,945577621,695577621,278.23104839999996,5119788,2.0479152000000003,tt2310332,4,JP,en
21,22,"Dec 17, 2014",The Hobbit: The Battle of the Five Armies,250000000,255119788,945577621,695577621,278.23104839999996,5119788,2.0479152000000003,tt2310332,55,XEU,en
28,29,"Jun 14, 2013",Man of Steel,225000000,291045518,667999518,442999518,196.88867466666667,66045518,29.353563555555557,tt0770828,17,HK,en
28,29,"Jun 14, 2013",Man of Steel,225000000,291045518,667999518,442999518,196.88867466666667,66045518,29.353563555555557,tt0770828,23,FI,sv
31,32,"May 18, 2012",Battleship,220000000,65233400,313477717,93477717,42.48987136363636,-154766600,-70.34845454545454,tt1440129,28,TR,tr
31,32,"May 18, 2012",Battleship,220000000,65233400,313477717,93477717,42.48987136363636,-154766600,-70.34845454545454,tt1440129,3,IL,he
33,34,"Jun 12, 2015",Jurassic World,215000000,652270625,1648854864,1433854864,666.9092390697674,437270625,203.38168604651165,tt0369610,43,TR,tr
34,35,"May 25, 2012",Men in Black 3,215000000,179020854,654213485,439213485,204.2853418604651,-35979146,-16.734486511627907,tt1409024,32,JP,en
38,39,"May 14, 2010",Robin Hood,210000000,105487148,322459006,112459006,53.551907619047626,-104512852,-49.76802476190476,tt0955308,13,TR,tr
38,39,"May 14, 2010",Robin Hood,210000000,105487148,322459006,112459006,53.551907619047626,-104512852,-49.76802476190476,tt0955308,14,FI,sv
38,39,"May 14, 2010",Robin Hood,210000000,105487148,322459006,112459006,53.551907619047626,-104512852,-49.76802476190476,tt0955308,18,CA,en
38,39,"May 14, 2010",Robin Hood,210000000,105487148,322459006,112459006,53.551907619047626,-104512852,-49.76802476190476,tt0955308,26,JP,en
38,39,"May 14, 2010",Robin Hood,210000000,105487148,322459006,112459006,53.551907619047626,-104512852,-49.76802476190476,tt0955308,4,CA,fr
38,39,"May 14, 2010",Robin Hood,210000000,105487148,322459006,112459006,53.551907619047626,-104512852,-49.76802476190476,tt4532826,14,TR,tr
38,39,"May 14, 2010",Robin Hood,210000000,105487148,322459006,112459006,53.551907619047626,-104512852,-49.76802476190476,tt4532826,9,IL,he
408,9,"Nov 21, 2018",Robin Hood,99000000,30824628,84747441,-14252559,-14.396524242424242,-68175372,-68.86401212121213,tt0955308,13,TR,tr
408,9,"Nov 21, 2018",Robin Hood,99000000,30824628,84747441,-14252559,-14.396524242424242,-68175372,-68.86401212121213,tt0955308,14,FI,sv
408,9,"Nov 21, 2018",Robin Hood,99000000,30824628,84747441,-14252559,-14.396524242424242,-68175372,-68.86401212121213,tt0955308,18,CA,en
408,9,"Nov 21, 2018",Robin Hood,99000000,30824628,84747441,-14252559,-14.396524242424242,-68175372,-68.86401212121213,tt0955308,26,JP,en
408,9,"Nov 21, 2018",Robin Hood,99000000,30824628,84747441,-14252559,-14.396524242424242,-68175372,-68.86401212121213,tt0955308,4,CA,fr
408,9,"Nov 21, 2018",Robin Hood,99000000,30824628,84747441,-14252559,-14.396524242424242,-68175372,-68.86401212121213,tt4532826,14,TR,tr
408,9,"Nov 21, 2018",Robin Hood,99000000,30824628,84747441,-14252559,-14.396524242424242,-68175372,-68.86401212121213,tt4532826,9,IL,he
41,42,"Feb 16, 2018",Black Panther,200000000,700059566,1348258224,1148258224,574.129112,500059566,250.029783,tt1825683,16,US,en
41,42,"Feb 16, 2018",Black Panther,200000000,700059566,1348258224,1148258224,574.129112,500059566,250.029783,tt1825683,17,XWW,en
41,42,"Feb 16, 2018",Black Panther,200000000,700059566,1348258224,1148258224,574.129112,500059566,250.029783,tt1825683,26,TR,tr
41,42,"Feb 16, 2018",Black Panther,200000000,700059566,1348258224,1148258224,574.129112,500059566,250.029783,tt2905856,4,XWW,en
44,45,"Dec 16, 2016",Rogue One: A Star Wars Story,200000000,532177324,1049102856,849102856,424.551428,332177324,166.088662,tt3748528,5,US,en
44,45,"Dec 16, 2016",Rogue One: A Star Wars Story,200000000,532177324,1049102856,849102856,424.551428,332177324,166.088662,tt3748528,7,XWW,en
46,47,"Jun 18, 2010",Toy Story 3,200000000,415004880,1068879522,868879522,434.439761,215004880,107.50243999999999,tt0435761,21,JP,en
47,48,"May 3, 2013",Iron Man 3,200000000,408992272,1215392272,1015392272,507.696136,208992272,104.496136,tt1300854,22,CA,fr
47,48,"May 3, 2013",Iron Man 3,200000000,408992272,1215392272,1015392272,507.696136,208992272,104.496136,tt1300854,23,GB,en
47,48,"May 3, 2013",Iron Man 3,200000000,408992272,1215392272,1015392272,507.696136,208992272,104.496136,tt1300854,38,US,en
47,48,"May 3, 2013",Iron Man 3,200000000,408992272,1215392272,1015392272,507.696136,208992272,104.496136,tt1300854,4,TR,tr
47,48,"May 3, 2013",Iron Man 3,200000000,408992272,1215392272,1015392272,507.696136,208992272,104.496136,tt1300854,8,IL,he
50,51,"Mar 5, 2010",Alice in Wonderland,200000000,334191110,1025491110,825491110,412.74555499999997,134191110,67.09555499999999,tt1014759,3,JP,en
4759,60,"Jul 28, 1951",Alice in Wonderland,3000000,0,0,-3000000,-100.0,-3000000,-100.0,tt1014759,3,JP,en
51,52,"Nov 8, 2012",Skyfall,200000000,304360277,1110526981,910526981,455.2634905,104360277,52.1801385,tt1074638,11,IL,he
51,52,"Nov 8, 2012",Skyfall,200000000,304360277,1110526981,910526981,455.2634905,104360277,52.1801385,tt1074638,23,TR,tr
51,52,"Nov 8, 2012",Skyfall,200000000,304360277,1110526981,910526981,455.2634905,104360277,52.1801385,tt1074638,36,CA,en
51,52,"Nov 8, 2012",Skyfall,200000000,304360277,1110526981,910526981,455.2634905,104360277,52.1801385,tt1074638,9,CA,fr
61,62,"Jun 17, 2011",Green Lantern,200000000,116601172,219535492,19535492,9.767745999999999,-83398828,-41.699414000000004,tt1133985,3,IL,he
63,64,"Jun 29, 2011",Transformers: Dark of the Moon,195000000,352390543,1123790543,928790543,476.3028425641026,157390543,80.71309897435897,tt1399103,16,XWW,en
63,64,"Jun 29, 2011",Transformers: Dark of the Moon,195000000,352390543,1123790543,928790543,476.3028425641026,157390543,80.71309897435897,tt1399103,41,US,en
76,77,"Jun 22, 2012",Brave,185000000,237282182,554606532,369606532,199.7873145945946,52282182,28.260638918918918,tt1217209,4,HK,en
77,78,"Mar 10, 2017",Kong: Skull Island,185000000,168052812,561072059,376072059,203.28219405405403,-16947188,-9.160642162162162,tt3731562,13,CA,fr
79,80,"Oct 6, 2017",Blade Runner 2049,185000000,92054159,259357408,74357408,40.19319351351351,-92945841,-50.24099513513514,tt1856101,22,CA,fr
79,80,"Oct 6, 2017",Blade Runner 2049,185000000,92054159,259357408,74357408,40.19319351351351,-92945841,-50.24099513513514,tt1856101,25,IL,he
79,80,"Oct 6, 2017",Blade Runner 2049,185000000,92054159,259357408,74357408,40.19319351351351,-92945841,-50.24099513513514,tt1856101,31,US,en
79,80,"Oct 6, 2017",Blade Runner 2049,185000000,92054159,259357408,74357408,40.19319351351351,-92945841,-50.24099513513514,tt1856101,7,XWW,en
79,80,"Oct 6, 2017",Blade Runner 2049,185000000,92054159,259357408,74357408,40.19319351351351,-92945841,-50.24099513513514,tt1856101,8,LU,fr
80,81,"May 24, 2019",Aladdin,182000000,246734314,619234314,437234314,240.23863406593406,64734314,35.56830439560439,tt6139732,16,XWW,en
80,81,"May 24, 2019",Aladdin,182000000,246734314,619234314,437234314,240.23863406593406,64734314,35.56830439560439,tt6139732,24,IE,en
80,81,"May 24, 2019",Aladdin,182000000,246734314,619234314,437234314,240.23863406593406,64734314,35.56830439560439,tt6139732,29,US,en
80,81,"May 24, 2019",Aladdin,182000000,246734314,619234314,437234314,240.23863406593406,64734314,35.56830439560439,tt6139732,30,IN,hi
80,81,"May 24, 2019",Aladdin,182000000,246734314,619234314,437234314,240.23863406593406,64734314,35.56830439560439,tt6139732,32,TR,tr
80,81,"May 24, 2019",Aladdin,182000000,246734314,619234314,437234314,240.23863406593406,64734314,35.56830439560439,tt6139732,4,IL,he
80,81,"May 24, 2019",Aladdin,182000000,246734314,619234314,437234314,240.23863406593406,64734314,35.56830439560439,tt6139732,8,CA,fr
2032,33,"Nov 11, 1992",Aladdin,28000000,217350219,504050219,476050219,1700.1793535714285,189350219,676.2507821428571,tt6139732,16,XWW,en
2032,33,"Nov 11, 1992",Aladdin,28000000,217350219,504050219,476050219,1700.1793535714285,189350219,676.2507821428571,tt6139732,24,IE,en
2032,33,"Nov 11, 1992",Aladdin,28000000,217350219,504050219,476050219,1700.1793535714285,189350219,676.2507821428571,tt6139732,29,US,en
2032,33,"Nov 11, 1992",Aladdin,28000000,217350219,504050219,476050219,1700.1793535714285,189350219,676.2507821428571,tt6139732,30,IN,hi
2032,33,"Nov 11, 1992",Aladdin,28000000,217350219,504050219,476050219,1700.1793535714285,189350219,676.2507821428571,tt6139732,32,TR,tr
2032,33,"Nov 11, 1992",Aladdin,28000000,217350219,504050219,476050219,1700.1793535714285,189350219,676.2507821428571,tt6139732,4,IL,he
2032,33,"Nov 11, 1992",Aladdin,28000000,217350219,504050219,476050219,1700.1793535714285,189350219,676.2507821428571,tt6139732,8,CA,fr
81,82,"Nov 3, 2017",Thor: Ragnarok,180000000,315058289,846980024,666980024,370.5444577777778,135058289,75.03238277777777,tt3501632,15,IL,he
81,82,"Nov 3, 2017",Thor: Ragnarok,180000000,315058289,846980024,666980024,370.5444577777778,135058289,75.03238277777777,tt3501632,24,CA,fr
81,82,"Nov 3, 2017",Thor: Ragnarok,180000000,315058289,846980024,666980024,370.5444577777778,135058289,75.03238277777777,tt3501632,27,IN,en
81,82,"Nov 3, 2017",Thor: Ragnarok,180000000,315058289,846980024,666980024,370.5444577777778,135058289,75.03238277777777,tt3501632,33,XWW,en
81,82,"Nov 3, 2017",Thor: Ragnarok,180000000,315058289,846980024,666980024,370.5444577777778,135058289,75.03238277777777,tt3501632,5,US,en
83,84,"May 30, 2014",Maleficent,180000000,241407328,758536735,578536735,321.4092972222222,61407328,34.115182222222224,tt1587310,31,IL,he
83,84,"May 30, 2014",Maleficent,180000000,241407328,758536735,578536735,321.4092972222222,61407328,34.115182222222224,tt1587310,8,JM,en
84,85,"Nov 18, 2016",Fantastic Beasts and Where to Find Them,180000000,234037575,802402853,622402853,345.7793627777778,54037575,30.020875000000004,tt3183660,36,XWW,en
84,85,"Nov 18, 2016",Fantastic Beasts and Where to Find Them,180000000,234037575,802402853,622402853,345.7793627777778,54037575,30.020875000000004,tt3183660,37,GB,en
88,89,"Nov 23, 2011",Hugo,180000000,73864507,180047784,47784,0.026546666666666666,-106135493,-58.96416277777777,tt0970179,20,FI,sv
88,89,"Nov 23, 2011",Hugo,180000000,73864507,180047784,47784,0.026546666666666666,-106135493,-58.96416277777777,tt0970179,21,IR,fa
88,89,"Nov 23, 2011",Hugo,180000000,73864507,180047784,47784,0.026546666666666666,-106135493,-58.96416277777777,tt0970179,23,TR,tr
88,89,"Nov 23, 2011",Hugo,180000000,73864507,180047784,47784,0.026546666666666666,-106135493,-58.96416277777777,tt0970179,28,IL,he
88,89,"Nov 23, 2011",Hugo,180000000,73864507,180047784,47784,0.026546666666666666,-106135493,-58.96416277777777,tt0970179,35,CA,fr
92,93,"May 27, 2016",X-Men: Apocalypse,178000000,155442489,542537546,364537546,204.79637415730338,-22557511,-12.672758988764047,tt3385516,29,CA,fr
94,95,"Jun 6, 2014",Edge of Tomorrow,178000000,100206256,370541256,192541256,108.16924494382023,-77793744,-43.70435056179775,tt1631867,24,XWW,en
95,96,"Mar 8, 2019",Captain Marvel,175000000,426525952,1123061550,948061550,541.7494571428572,251525952,143.72911542857142,tt4154664,12,XWW,en
95,96,"Mar 8, 2019",Captain Marvel,175000000,426525952,1123061550,948061550,541.7494571428572,251525952,143.72911542857142,tt4154664,16,BD,en
95,96,"Mar 8, 2019",Captain Marvel,175000000,426525952,1123061550,948061550,541.7494571428572,251525952,143.72911542857142,tt4154664,28,US,en
95,96,"Mar 8, 2019",Captain Marvel,175000000,426525952,1123061550,948061550,541.7494571428572,251525952,143.72911542857142,tt4154664,2,IL,he
95,96,"Mar 8, 2019",Captain Marvel,175000000,426525952,1123061550,948061550,541.7494571428572,251525952,143.72911542857142,tt4154664,4,TR,tr
97,98,"Jun 19, 2015",Inside Out,175000000,356461711,854235992,679235992,388.1348525714286,181461711,103.69240628571428,tt1865538,1,XWW,en
97,98,"Jun 19, 2015",Inside Out,175000000,356461711,854235992,679235992,388.1348525714286,181461711,103.69240628571428,tt2096673,32,SG,en
98,99,"Jul 7, 2017",Spider-Man: Homecoming,175000000,334201140,880166350,705166350,402.9522,159201140,90.97208,tt2250912,13,IN,en
99,100,"Aug 5, 2016",Suicide Squad,175000000,325100054,746059887,571059887,326.31993542857145,150100054,85.77145942857143,tt1386697,26,XWW,en
99,100,"Aug 5, 2016",Suicide Squad,175000000,325100054,746059887,571059887,326.31993542857145,150100054,85.77145942857143,tt1386697,33,US,en
101,2,"Nov 22, 2017",Coco,175000000,209726015,798008101,623008101,356.00462914285714,34726015,19.84343714285714,tt2380307,24,CA,fr
101,2,"Nov 22, 2017",Coco,175000000,209726015,798008101,623008101,356.00462914285714,34726015,19.84343714285714,tt2380307,33,TR,tr
101,2,"Nov 22, 2017",Coco,175000000,209726015,798008101,623008101,356.00462914285714,34726015,19.84343714285714,tt2380307,5,IL,he
104,5,"Jun 16, 2017",Cars 3,175000000,152901115,383541369,208541369,119.16649657142857,-22098885,-12.627934285714284,tt3606752,14,CA,en
111,12,"Dec 25, 2013",47 Ronin,175000000,38362475,151716815,-23283185,-13.304677142857143,-136637525,-78.07858571428572,tt1335975,13,CA,fr
111,12,"Dec 25, 2013",47 Ronin,175000000,38362475,151716815,-23283185,-13.304677142857143,-136637525,-78.07858571428572,tt1335975,8,TR,tr
113,14,"Aug 1, 2014",Guardians of the Galaxy,170000000,333172112,770867516,600867516,353.45148,163172112,95.98359529411765,tt2015381,36,CA,en
114,15,"May 7, 2010",Iron Man 2,170000000,312433331,621156389,451156389,265.3861111764706,142433331,83.78431235294119,tt1228705,19,JP,en
114,15,"May 7, 2010",Iron Man 2,170000000,312433331,621156389,451156389,265.3861111764706,142433331,83.78431235294119,tt1228705,22,CA,fr
114,15,"May 7, 2010",Iron Man 2,170000000,312433331,621156389,451156389,265.3861111764706,142433331,83.78431235294119,tt1228705,5,IL,he
114,15,"May 7, 2010",Iron Man 2,170000000,312433331,621156389,451156389,265.3861111764706,142433331,83.78431235294119,tt1228705,6,TR,tr
121,22,"Mar 29, 2019",Dumbo,170000000,113883318,345004422,175004422,102.94377764705882,-56116682,-33.00981294117647,tt3861390,16,IL,he
121,22,"Mar 29, 2019",Dumbo,170000000,113883318,345004422,175004422,102.94377764705882,-56116682,-33.00981294117647,tt3861390,17,CA,fr
121,22,"Mar 29, 2019",Dumbo,170000000,113883318,345004422,175004422,102.94377764705882,-56116682,-33.00981294117647,tt3861390,24,US,en
121,22,"Mar 29, 2019",Dumbo,170000000,113883318,345004422,175004422,102.94377764705882,-56116682,-33.00981294117647,tt3861390,27,TR,tr
121,22,"Mar 29, 2019",Dumbo,170000000,113883318,345004422,175004422,102.94377764705882,-56116682,-33.00981294117647,tt3861390,5,XWW,en
123,24,"Feb 14, 2019",Alita: Battle Angel,170000000,85710210,402976036,232976036,137.04472705882353,-84289790,-49.58222941176471,tt0437086,20,XWW,en
123,24,"Feb 14, 2019",Alita: Battle Angel,170000000,85710210,402976036,232976036,137.04472705882353,-84289790,-49.58222941176471,tt0437086,21,US,en
123,24,"Feb 14, 2019",Alita: Battle Angel,170000000,85710210,402976036,232976036,137.04472705882353,-84289790,-49.58222941176471,tt0437086,5,BD,en
127,28,"Nov 4, 2016",Doctor Strange,165000000,232641920,676404566,511404566,309.94216121212116,67641920,40.995103030303035,tt1211837,16,IL,he
131,32,"Nov 5, 2014",Interstellar,165000000,188017894,666379375,501379375,303.8662878787879,23017894,13.950238787878789,tt0816692,2,US,en
131,32,"Nov 5, 2014",Interstellar,165000000,188017894,666379375,501379375,303.8662878787879,23017894,13.950238787878789,tt0816692,8,XWW,en
134,35,"Mar 17, 2017",Beauty and the Beast,160000000,504014165,1259199706,1099199706,686.99981625,344014165,215.00885312500003,tt2316801,21,XWW,en
2485,86,"Nov 13, 1991",Beauty and the Beast,20000000,376057266,608431132,588431132,2942.15566,356057266,1780.28633,tt2316801,21,XWW,en
135,36,"Dec 21, 2018",Aquaman,160000000,335061807,1146894640,986894640,616.80915,175061807,109.41362937500001,tt1477834,11,BD,en
135,36,"Dec 21, 2018",Aquaman,160000000,335061807,1146894640,986894640,616.80915,175061807,109.41362937500001,tt1477834,26,IL,he
135,36,"Dec 21, 2018",Aquaman,160000000,335061807,1146894640,986894640,616.80915,175061807,109.41362937500001,tt1477834,2,TR,tr
135,36,"Dec 21, 2018",Aquaman,160000000,335061807,1146894640,986894640,616.80915,175061807,109.41362937500001,tt1477834,3,CA,fr
135,36,"Dec 21, 2018",Aquaman,160000000,335061807,1146894640,986894640,616.80915,175061807,109.41362937500001,tt1477834,4,ID,en
137,38,"Jul 16, 2010",Inception,160000000,292576195,835524642,675524642,422.20290125,132576195,82.860121875,tt1375666,40,XWW,en
137,38,"Jul 16, 2010",Inception,160000000,292576195,835524642,675524642,422.20290125,132576195,82.860121875,tt1375666,8,US,en
138,39,"Nov 20, 2015",The Hunger Games: Mockingjay - Part 2,160000000,281723902,648986787,488986787,305.616741875,121723902,76.07743875,tt1951266,22,CA,en
140,41,"May 16, 2014",Godzilla,160000000,200676069,529076069,369076069,230.67254312499998,40676069,25.422543125,tt0831387,13,TR,tr
140,41,"May 16, 2014",Godzilla,160000000,200676069,529076069,369076069,230.67254312499998,40676069,25.422543125,tt0831387,16,IL,he
140,41,"May 16, 2014",Godzilla,160000000,200676069,529076069,369076069,230.67254312499998,40676069,25.422543125,tt0831387,3,LU,fr
140,41,"May 16, 2014",Godzilla,160000000,200676069,529076069,369076069,230.67254312499998,40676069,25.422543125,tt0831387,9,CA,fr
273,74,"May 19, 1998",Godzilla,125000000,136314294,376000000,251000000,200.8,11314294,9.0514352,tt0831387,13,TR,tr
273,74,"May 19, 1998",Godzilla,125000000,136314294,376000000,251000000,200.8,11314294,9.0514352,tt0831387,16,IL,he
273,74,"May 19, 1998",Godzilla,125000000,136314294,376000000,251000000,200.8,11314294,9.0514352,tt0831387,3,LU,fr
273,74,"May 19, 1998",Godzilla,125000000,136314294,376000000,251000000,200.8,11314294,9.0514352,tt0831387,9,CA,fr
141,42,"Jun 3, 2011",X-Men: First Class,160000000,146408305,355408305,195408305,122.13019062499998,-13591695,-8.494809374999999,tt1270798,21,CA,en
141,42,"Jun 3, 2011",X-Men: First Class,160000000,146408305,355408305,195408305,122.13019062499998,-13591695,-8.494809374999999,tt1270798,23,US,en
141,42,"Jun 3, 2011",X-Men: First Class,160000000,146408305,355408305,195408305,122.13019062499998,-13591695,-8.494809374999999,tt1270798,40,GB,en
146,47,"Sep 30, 2016",Deepwater Horizon,156000000,61433527,122603824,-33396176,-21.40780512820513,-94566473,-60.61953397435897,tt1860357,19,HK,en
146,47,"Sep 30, 2016",Deepwater Horizon,156000000,61433527,122603824,-33396176,-21.40780512820513,-94566473,-60.61953397435897,tt1860357,23,XWW,en
148,49,"Jul 1, 2015",Terminator: Genisys,155000000,89760956,432150894,277150894,178.80702838709678,-65239044,-42.08970580645161,tt1340138,24,CA,fr
154,55,"Jun 2, 2017",Wonder Woman,150000000,412563408,821133378,671133378,447.42225199999996,262563408,175.042272,tt0451279,11,CA,fr
154,55,"Jun 2, 2017",Wonder Woman,150000000,412563408,821133378,671133378,447.42225199999996,262563408,175.042272,tt0451279,14,XWW,en
154,55,"Jun 2, 2017",Wonder Woman,150000000,412563408,821133378,671133378,447.42225199999996,262563408,175.042272,tt0451279,25,US,en
154,55,"Jun 2, 2017",Wonder Woman,150000000,412563408,821133378,671133378,447.42225199999996,262563408,175.042272,tt0451279,31,IL,he
154,55,"Jun 2, 2017",Wonder Woman,150000000,412563408,821133378,671133378,447.42225199999996,262563408,175.042272,tt0451279,7,TR,tr
155,56,"Nov 22, 2013",Frozen,150000000,400738009,1272469910,1122469910,748.3132733333333,250738009,167.15867266666666,tt1323045,11,NZ,en
155,56,"Nov 22, 2013",Frozen,150000000,400738009,1272469910,1122469910,748.3132733333333,250738009,167.15867266666666,tt1323045,20,IE,en
155,56,"Nov 22, 2013",Frozen,150000000,400738009,1272469910,1122469910,748.3132733333333,250738009,167.15867266666666,tt1323045,21,CA,en
155,56,"Nov 22, 2013",Frozen,150000000,400738009,1272469910,1122469910,748.3132733333333,250738009,167.15867266666666,tt1323045,4,TR,tr
155,56,"Nov 22, 2013",Frozen,150000000,400738009,1272469910,1122469910,748.3132733333333,250738009,167.15867266666666,tt1323045,8,JP,en
155,56,"Nov 22, 2013",Frozen,150000000,400738009,1272469910,1122469910,748.3132733333333,250738009,167.15867266666666,tt2294629,11,FI,sv
155,56,"Nov 22, 2013",Frozen,150000000,400738009,1272469910,1122469910,748.3132733333333,250738009,167.15867266666666,tt2294629,44,MY,en
155,56,"Nov 22, 2013",Frozen,150000000,400738009,1272469910,1122469910,748.3132733333333,250738009,167.15867266666666,tt1611845,1,HK,en
155,56,"Nov 22, 2013",Frozen,150000000,400738009,1272469910,1122469910,748.3132733333333,250738009,167.15867266666666,tt1611845,2,XWW,en
156,57,"Mar 4, 2016",Zootopia,150000000,341268248,1019429616,869429616,579.6197440000001,191268248,127.51216533333334,tt2948356,25,JP,en
156,57,"Mar 4, 2016",Zootopia,150000000,341268248,1019429616,869429616,579.6197440000001,191268248,127.51216533333334,tt2948356,27,HK,en
156,57,"Mar 4, 2016",Zootopia,150000000,341268248,1019429616,869429616,579.6197440000001,191268248,127.51216533333334,tt2948356,48,CA,fr
161,62,"Nov 23, 2016",Moana,150000000,248757044,637517365,487517365,325.01157666666666,98757044,65.83802933333334,tt3521164,10,CA,fr
161,62,"Nov 23, 2016",Moana,150000000,248757044,637517365,487517365,325.01157666666666,98757044,65.83802933333334,tt3521164,14,IL,he
165,66,"Nov 8, 2013",Thor: The Dark World,150000000,206362140,644602516,494602516,329.7350106666667,56362140,37.574760000000005,tt1981115,31,CA,en
168,69,"Jul 21, 2017",Dunkirk,150000000,190068280,499837368,349837368,233.22491200000002,40068280,26.712186666666664,tt5013056,12,IL,he
168,69,"Jul 21, 2017",Dunkirk,150000000,190068280,499837368,349837368,233.22491200000002,40068280,26.712186666666664,tt5013056,15,TR,tr
168,69,"Jul 21, 2017",Dunkirk,150000000,190068280,499837368,349837368,233.22491200000002,40068280,26.712186666666664,tt5013056,25,US,en
168,69,"Jul 21, 2017",Dunkirk,150000000,190068280,499837368,349837368,233.22491200000002,40068280,26.712186666666664,tt5013056,5,GB,en
169,70,"May 6, 2011",Thor,150000000,181030624,449326618,299326618,199.55107866666665,31030624,20.68708266666667,tt0800369,13,CA,fr
169,70,"May 6, 2011",Thor,150000000,181030624,449326618,299326618,199.55107866666665,31030624,20.68708266666667,tt0800369,1,FI,sv
169,70,"May 6, 2011",Thor,150000000,181030624,449326618,299326618,199.55107866666665,31030624,20.68708266666667,tt0800369,2,IL,he
169,70,"May 6, 2011",Thor,150000000,181030624,449326618,299326618,199.55107866666665,31030624,20.68708266666667,tt0800369,3,TR,tr
173,74,"May 26, 2011",Kung Fu Panda 2,150000000,165249063,664837547,514837547,343.22503133333333,15249063,10.166042000000001,tt1302011,22,TR,tr
173,74,"May 26, 2011",Kung Fu Panda 2,150000000,165249063,664837547,514837547,343.22503133333333,15249063,10.166042000000001,tt1302011,3,CA,fr
174,75,"May 15, 2015",Mad Max: Fury Road,150000000,153636354,370098020,220098020,146.73201333333336,3636354,2.424236,tt1392190,8,TR,tr
191,92,"Feb 17, 2017",The Great Wall,150000000,45157105,334486852,184486852,122.99123466666666,-104842895,-69.89526333333333,tt2034800,6,CA,en
192,93,"Oct 9, 2015",Pan,150000000,35088320,151525973,1525973,1.0173153333333333,-114911680,-76.60778666666667,tt3332064,17,CA,fr
192,93,"Oct 9, 2015",Pan,150000000,35088320,151525973,1525973,1.0173153333333333,-114911680,-76.60778666666667,tt3332064,8,IL,he
199,100,"Jun 16, 1999",Tarzan,145000000,171091819,448191819,303191819,209.09780620689654,26091819,17.994357931034482,tt1705952,11,IL,he
199,100,"Jun 16, 1999",Tarzan,145000000,171091819,448191819,303191819,209.09780620689654,26091819,17.994357931034482,tt1705952,14,TR,tr
199,100,"Jun 16, 1999",Tarzan,145000000,171091819,448191819,303191819,209.09780620689654,26091819,17.994357931034482,tt1705952,6,CA,fr
202,3,"Apr 8, 2005",Sahara,145000000,68671925,121671925,-23328075,-16.088327586206898,-76328075,-52.640051724137926,tt4466894,1,CA,fr
203,4,"Jul 15, 2016",Ghostbusters,144000000,128350574,229008658,85008658,59.033790277777776,-15649426,-10.867656944444445,tt1289401,3,US,en
203,4,"Jul 15, 2016",Ghostbusters,144000000,128350574,229008658,85008658,59.033790277777776,-15649426,-10.867656944444445,tt1289401,4,XWW,en
1835,36,"Jun 8, 1984",Ghostbusters,30000000,242212467,295212467,265212467,884.0415566666668,212212467,707.37489,tt1289401,3,US,en
1835,36,"Jun 8, 1984",Ghostbusters,30000000,242212467,295212467,265212467,884.0415566666668,212212467,707.37489,tt1289401,4,XWW,en
210,11,"Jan 29, 2016",Kung Fu Panda 3,140000000,143528619,517599142,377599142,269.71367285714285,3528619,2.520442142857143,tt2267968,14,IL,he
212,13,"Mar 27, 2013",G.I. Joe: Retaliation,140000000,122523060,375740705,235740705,168.38621785714284,-17476940,-12.483528571428572,tt1583421,18,CM,fr
216,17,"Jul 1, 2016",The BFG,140000000,55483770,199646680,59646680,42.60477142857143,-84516230,-60.36873571428571,tt3691740,37,XWW,en
228,29,"Mar 4, 2011",Rango,135000000,123477607,245724600,110724600,82.01822222222222,-11522393,-8.535105925925926,tt1192628,19,TR,tr
228,29,"Mar 4, 2011",Rango,135000000,123477607,245724600,110724600,82.01822222222222,-11522393,-8.535105925925926,tt1192628,20,CA,fr
228,29,"Mar 4, 2011",Rango,135000000,123477607,245724600,110724600,82.01822222222222,-11522393,-8.535105925925926,tt1192628,8,IL,he
230,31,"Jul 17, 2013",Turbo,135000000,83028130,286896578,151896578,112.51598370370371,-51971870,-38.497681481481486,tt1860353,10,CA,fr
230,31,"Jul 17, 2013",Turbo,135000000,83028130,286896578,151896578,112.51598370370371,-51971870,-38.497681481481486,tt1860353,16,TR,tr
237,38,"Nov 22, 2013",The Hunger Games: Catching Fire,130000000,424668047,864868047,734868047,565.2831130769231,294668047,226.66772846153847,tt1951264,16,CA,en
242,43,"Jul 17, 2015",Ant-Man,130000000,180202163,518858449,388858449,299.1218838461538,50202163,38.61704846153846,tt0478970,16,CA,fr
242,43,"Jul 17, 2015",Ant-Man,130000000,180202163,518858449,388858449,299.1218838461538,50202163,38.61704846153846,tt0478970,29,CA,en
242,43,"Jul 17, 2015",Ant-Man,130000000,180202163,518858449,388858449,299.1218838461538,50202163,38.61704846153846,tt0478970,6,TR,tr
243,44,"Mar 27, 2015",Home,130000000,177397510,385997896,255997896,196.92145846153846,47397510,36.45962307692307,tt2075392,1,XWW,en
243,44,"Mar 27, 2015",Home,130000000,177397510,385997896,255997896,196.92145846153846,47397510,36.45962307692307,tt2372760,3,XWW,en
243,44,"Mar 27, 2015",Home,130000000,177397510,385997896,255997896,196.92145846153846,47397510,36.45962307692307,tt2093100,3,XWW,en
243,44,"Mar 27, 2015",Home,130000000,177397510,385997896,255997896,196.92145846153846,47397510,36.45962307692307,tt3506448,2,XWW,en
243,44,"Mar 27, 2015",Home,130000000,177397510,385997896,255997896,196.92145846153846,47397510,36.45962307692307,tt5775862,1,GB,en
243,44,"Mar 27, 2015",Home,130000000,177397510,385997896,255997896,196.92145846153846,47397510,36.45962307692307,tt5775862,2,XWW,en
243,44,"Mar 27, 2015",Home,130000000,177397510,385997896,255997896,196.92145846153846,47397510,36.45962307692307,tt4873154,2,XWW,en
243,44,"Mar 27, 2015",Home,130000000,177397510,385997896,255997896,196.92145846153846,47397510,36.45962307692307,tt8601408,2,XWW,en
243,44,"Mar 27, 2015",Home,130000000,177397510,385997896,255997896,196.92145846153846,47397510,36.45962307692307,tt5884960,1,XWW,en
243,44,"Mar 27, 2015",Home,130000000,177397510,385997896,255997896,196.92145846153846,47397510,36.45962307692307,tt3289416,2,XWW,en
3455,56,"Jun 5, 2009",Home,12000000,0,0,-12000000,-100.0,-12000000,-100.0,tt2075392,1,XWW,en
3455,56,"Jun 5, 2009",Home,12000000,0,0,-12000000,-100.0,-12000000,-100.0,tt2372760,3,XWW,en
3455,56,"Jun 5, 2009",Home,12000000,0,0,-12000000,-100.0,-12000000,-100.0,tt2093100,3,XWW,en
3455,56,"Jun 5, 2009",Home,12000000,0,0,-12000000,-100.0,-12000000,-100.0,tt3506448,2,XWW,en
3455,56,"Jun 5, 2009",Home,12000000,0,0,-12000000,-100.0,-12000000,-100.0,tt5775862,1,GB,en
3455,56,"Jun 5, 2009",Home,12000000,0,0,-12000000,-100.0,-12000000,-100.0,tt5775862,2,XWW,en
3455,56,"Jun 5, 2009",Home,12000000,0,0,-12000000,-100.0,-12000000,-100.0,tt4873154,2,XWW,en
3455,56,"Jun 5, 2009",Home,12000000,0,0,-12000000,-100.0,-12000000,-100.0,tt8601408,2,XWW,en
3455,56,"Jun 5, 2009",Home,12000000,0,0,-12000000,-100.0,-12000000,-100.0,tt5884960,1,XWW,en
3455,56,"Jun 5, 2009",Home,12000000,0,0,-12000000,-100.0,-12000000,-100.0,tt3289416,2,XWW,en
5459,60,"Apr 23, 2009",Home,500000,15433,44793168,44293168,8858.633600000001,-484567,-96.91340000000001,tt2075392,1,XWW,en
5459,60,"Apr 23, 2009",Home,500000,15433,44793168,44293168,8858.633600000001,-484567,-96.91340000000001,tt2372760,3,XWW,en
5459,60,"Apr 23, 2009",Home,500000,15433,44793168,44293168,8858.633600000001,-484567,-96.91340000000001,tt2093100,3,XWW,en
5459,60,"Apr 23, 2009",Home,500000,15433,44793168,44293168,8858.633600000001,-484567,-96.91340000000001,tt3506448,2,XWW,en
5459,60,"Apr 23, 2009",Home,500000,15433,44793168,44293168,8858.633600000001,-484567,-96.91340000000001,tt5775862,1,GB,en
5459,60,"Apr 23, 2009",Home,500000,15433,44793168,44293168,8858.633600000001,-484567,-96.91340000000001,tt5775862,2,XWW,en
5459,60,"Apr 23, 2009",Home,500000,15433,44793168,44293168,8858.633600000001,-484567,-96.91340000000001,tt4873154,2,XWW,en
5459,60,"Apr 23, 2009",Home,500000,15433,44793168,44293168,8858.633600000001,-484567,-96.91340000000001,tt8601408,2,XWW,en
5459,60,"Apr 23, 2009",Home,500000,15433,44793168,44293168,8858.633600000001,-484567,-96.91340000000001,tt5884960,1,XWW,en
5459,60,"Apr 23, 2009",Home,500000,15433,44793168,44293168,8858.633600000001,-484567,-96.91340000000001,tt3289416,2,XWW,en
245,46,"Oct 28, 2011",Puss in Boots,130000000,149260504,554987477,424987477,326.9134438461538,19260504,14.815772307692306,tt0448694,36,IN,en
246,47,"Nov 5, 2010",Megamind,130000000,148415853,321887208,191887208,147.60554461538462,18415853,14.16604076923077,tt1001526,25,CA,fr
248,49,"Apr 11, 2014",Rio 2,130000000,131538435,492846291,362846291,279.11253153846155,1538435,1.1834115384615385,tt2357291,22,TR,tr
248,49,"Apr 11, 2014",Rio 2,130000000,131538435,492846291,362846291,279.11253153846155,1538435,1.1834115384615385,tt2357291,4,CA,fr
249,50,"Jul 23, 2010",Salt,130000000,118311368,290650494,160650494,123.57730307692307,-11688632,-8.991255384615386,tt0944835,12,JP,en
249,50,"Jul 23, 2010",Salt,130000000,118311368,290650494,160650494,123.57730307692307,-11688632,-8.991255384615386,tt0944835,25,CA,en
249,50,"Jul 23, 2010",Salt,130000000,118311368,290650494,160650494,123.57730307692307,-11688632,-8.991255384615386,tt0944835,6,CA,fr
250,51,"Mar 28, 2014",Noah,130000000,101200044,352831065,222831065,171.40851153846154,-28799956,-22.15381230769231,tt1959490,3,JP,en
250,51,"Mar 28, 2014",Noah,130000000,101200044,352831065,222831065,171.40851153846154,-28799956,-22.15381230769231,tt1959490,8,ID,id
252,53,"May 31, 2013",After Earth,130000000,60522097,251499665,121499665,93.46128076923077,-69477903,-53.44454076923076,tt1815862,1,CA,en
254,55,"Jul 19, 2013",R.I.P.D.,130000000,33618855,79076678,-50923322,-39.171786153846156,-96381145,-74.13934230769232,tt0790736,23,CA,en
255,56,"Feb 22, 2019",How to Train Your Dragon: The Hidden World,129000000,160791800,519258283,390258283,302.52580077519383,31791800,24.644806201550388,tt2386490,19,XWW,en
255,56,"Feb 22, 2019",How to Train Your Dragon: The Hidden World,129000000,160791800,519258283,390258283,302.52580077519383,31791800,24.644806201550388,tt2386490,26,US,en
258,59,"Mar 3, 2017",Logan,127000000,226277068,615461394,488461394,384.6152708661417,99277068,78.17091968503938,tt3315342,29,CA,fr
258,59,"Mar 3, 2017",Logan,127000000,226277068,615461394,488461394,384.6152708661417,99277068,78.17091968503938,tt3315342,7,CA,en
261,62,"Nov 21, 2014",The Hunger Games: Mockingjay - Part 1,125000000,337135885,766575131,641575131,513.2601048,212135885,169.708708,tt1951265,25,CA,en
270,71,"Mar 31, 2017",The Boss Baby,125000000,175003033,510878762,385878762,308.7030096,50003033,40.002426400000004,tt3874544,13,CA,en
274,75,"Jun 8, 2012",Prometheus,125000000,126477084,402448265,277448265,221.95861200000002,1477084,1.1816672000000001,tt1446714,14,TR,tr
274,75,"Jun 8, 2012",Prometheus,125000000,126477084,402448265,277448265,221.95861200000002,1477084,1.1816672000000001,tt1446714,16,CA,fr
277,78,"Jul 13, 2018",Skyscraper,125000000,68420120,304115534,179115534,143.2924272,-56579880,-45.263904,tt1699233,2,XWW,en
280,81,"Jan 13, 2017",Monster Trucks,125000000,33370166,61642798,-63357202,-50.6857616,-91629834,-73.3038672,tt3095734,18,CA,en
285,86,"Jul 29, 2016",Jason Bourne,120000000,162192920,416168316,296168316,246.80692999999997,42192920,35.16076666666667,tt4196776,12,TH,en
285,86,"Jul 29, 2016",Jason Bourne,120000000,162192920,416168316,296168316,246.80692999999997,42192920,35.16076666666667,tt4196776,16,CA,fr
285,86,"Jul 29, 2016",Jason Bourne,120000000,162192920,416168316,296168316,246.80692999999997,42192920,35.16076666666667,tt4196776,1,XWW,en
285,86,"Jul 29, 2016",Jason Bourne,120000000,162192920,416168316,296168316,246.80692999999997,42192920,35.16076666666667,tt4196776,7,FI,sv
285,86,"Jul 29, 2016",Jason Bourne,120000000,162192920,416168316,296168316,246.80692999999997,42192920,35.16076666666667,tt4196776,8,IL,he
291,92,"Aug 9, 2013",Elysium,120000000,93050117,286192091,166192091,138.49340916666665,-26949883,-22.458235833333333,tt1535108,26,CA,fr
292,93,"Apr 19, 2013",Oblivion,120000000,89107235,287916633,167916633,139.93052749999998,-30892765,-25.743970833333336,tt1876409,4,US,en
292,93,"Apr 19, 2013",Oblivion,120000000,89107235,287916633,167916633,139.93052749999998,-30892765,-25.743970833333336,tt2611390,13,ET,en
293,94,"Mar 24, 2017",Power Rangers,120000000,85364450,142531552,22531552,18.77629333333333,-34635550,-28.86295833333333,tt3717490,13,IL,he
293,94,"Mar 24, 2017",Power Rangers,120000000,85364450,142531552,22531552,18.77629333333333,-34635550,-28.86295833333333,tt3717490,19,BG,bg
293,94,"Mar 24, 2017",Power Rangers,120000000,85364450,142531552,22531552,18.77629333333333,-34635550,-28.86295833333333,tt3717490,9,CA,fr
295,96,"Feb 12, 2014",RoboCop,120000000,58607007,242981799,122981799,102.4848325,-61392993,-51.160827499999996,tt1234721,14,CA,fr
295,96,"Feb 12, 2014",RoboCop,120000000,58607007,242981799,122981799,102.4848325,-61392993,-51.160827499999996,tt1234721,18,IL,he
3254,55,"Jul 17, 1987",RoboCop,13000000,53424681,53424681,40424681,310.9590846153846,40424681,310.9590846153846,tt1234721,14,CA,fr
3254,55,"Jul 17, 1987",RoboCop,13000000,53424681,53424681,40424681,310.9590846153846,40424681,310.9590846153846,tt1234721,18,IL,he
299,100,"Jul 22, 2005",The Island,120000000,35818913,163018913,43018913,35.84909416666667,-84181087,-70.15090583333333,tt1700468,3,XWW,en
299,100,"Jul 22, 2005",The Island,120000000,35818913,163018913,43018913,35.84909416666667,-84181087,-70.15090583333333,tt4391940,3,XWW,en
299,100,"Jul 22, 2005",The Island,120000000,35818913,163018913,43018913,35.84909416666667,-84181087,-70.15090583333333,tt6449204,1,XWW,en
299,100,"Jul 22, 2005",The Island,120000000,35818913,163018913,43018913,35.84909416666667,-84181087,-70.15090583333333,tt9823276,3,XWW,en
299,100,"Jul 22, 2005",The Island,120000000,35818913,163018913,43018913,35.84909416666667,-84181087,-70.15090583333333,tt8755316,3,XWW,en
299,100,"Jul 22, 2005",The Island,120000000,35818913,163018913,43018913,35.84909416666667,-84181087,-70.15090583333333,tt6335394,2,XWW,en
2434,35,"Jun 13, 1980",The Island,22000000,15716828,15716828,-6283172,-28.55987272727273,-6283172,-28.55987272727273,tt1700468,3,XWW,en
2434,35,"Jun 13, 1980",The Island,22000000,15716828,15716828,-6283172,-28.55987272727273,-6283172,-28.55987272727273,tt4391940,3,XWW,en
2434,35,"Jun 13, 1980",The Island,22000000,15716828,15716828,-6283172,-28.55987272727273,-6283172,-28.55987272727273,tt6449204,1,XWW,en
2434,35,"Jun 13, 1980",The Island,22000000,15716828,15716828,-6283172,-28.55987272727273,-6283172,-28.55987272727273,tt9823276,3,XWW,en
2434,35,"Jun 13, 1980",The Island,22000000,15716828,15716828,-6283172,-28.55987272727273,-6283172,-28.55987272727273,tt8755316,3,XWW,en
2434,35,"Jun 13, 1980",The Island,22000000,15716828,15716828,-6283172,-28.55987272727273,-6283172,-28.55987272727273,tt6335394,2,XWW,en
302,3,"Oct 5, 2018",Venom,116000000,213511408,853628605,737628605,635.8867284482758,97511408,84.06155862068965,tt1270797,13,HK,en
302,3,"Oct 5, 2018",Venom,116000000,213511408,853628605,737628605,635.8867284482758,97511408,84.06155862068965,tt1270797,24,IL,he
302,3,"Oct 5, 2018",Venom,116000000,213511408,853628605,737628605,635.8867284482758,97511408,84.06155862068965,tt1270797,5,CA,fr
302,3,"Oct 5, 2018",Venom,116000000,213511408,853628605,737628605,635.8867284482758,97511408,84.06155862068965,tt5244996,1,BD,en
2313,14,"Sep 16, 2005",Venom,25000000,881745,881745,-24118255,-96.47301999999999,-24118255,-96.47301999999999,tt1270797,13,HK,en
2313,14,"Sep 16, 2005",Venom,25000000,881745,881745,-24118255,-96.47301999999999,-24118255,-96.47301999999999,tt1270797,24,IL,he
2313,14,"Sep 16, 2005",Venom,25000000,881745,881745,-24118255,-96.47301999999999,-24118255,-96.47301999999999,tt1270797,5,CA,fr
2313,14,"Sep 16, 2005",Venom,25000000,881745,881745,-24118255,-96.47301999999999,-24118255,-96.47301999999999,tt5244996,1,BD,en
313,14,"Dec 15, 2017",Ferdinand,111000000,84410380,289847930,178847930,161.12426126126127,-26589620,-23.954612612612614,tt3411444,15,CA,fr
313,14,"Dec 15, 2017",Ferdinand,111000000,84410380,289847930,178847930,161.12426126126127,-26589620,-23.954612612612614,tt3411444,18,IL,he
314,15,"May 18, 2018",Deadpool 2,110000000,324591735,786680557,676680557,615.1641427272727,214591735,195.08339545454544,tt5463162,1,XWW,en
314,15,"May 18, 2018",Deadpool 2,110000000,324591735,786680557,676680557,615.1641427272727,214591735,195.08339545454544,tt5463162,27,CA,fr
314,15,"May 18, 2018",Deadpool 2,110000000,324591735,786680557,676680557,615.1641427272727,214591735,195.08339545454544,tt5463162,29,IL,he
314,15,"May 18, 2018",Deadpool 2,110000000,324591735,786680557,676680557,615.1641427272727,214591735,195.08339545454544,tt5463162,5,US,en
315,16,"Oct 4, 2013",Gravity,110000000,274092705,693698673,583698673,530.6351572727273,164092705,149.17518636363636,tt1454468,1,CA,en
315,16,"Oct 4, 2013",Gravity,110000000,274092705,693698673,583698673,530.6351572727273,164092705,149.17518636363636,tt4731148,4,XWW,en
315,16,"Oct 4, 2013",Gravity,110000000,274092705,693698673,583698673,530.6351572727273,164092705,149.17518636363636,tt5890698,1,PH,en
318,19,"May 29, 2015",San Andreas,110000000,155190832,456258539,346258539,314.78049,45190832,41.08257454545455,tt2126355,3,IL,he
318,19,"May 29, 2015",San Andreas,110000000,155190832,456258539,346258539,314.78049,45190832,41.08257454545455,tt2126355,6,CA,fr
324,25,"Jun 28, 2000",The Patriot,110000000,113330342,215300000,105300000,95.72727272727273,3330342,3.0275836363636364,tt7155152,2,XWW,en
335,36,"Nov 1, 2013",Ender's Game,110000000,61737191,127983283,17983283,16.348439090909093,-48262809,-43.87528090909091,tt1731141,31,PH,en
339,40,"Mar 31, 2017",Ghost in the Shell,110000000,40563557,167910690,57910690,52.64608181818182,-69436443,-63.12403909090909,tt1219827,14,CA,fr
339,40,"Mar 31, 2017",Ghost in the Shell,110000000,40563557,167910690,57910690,52.64608181818182,-69436443,-63.12403909090909,tt1219827,16,JP,en
339,40,"Mar 31, 2017",Ghost in the Shell,110000000,40563557,167910690,57910690,52.64608181818182,-69436443,-63.12403909090909,tt1219827,23,NZ,en
339,40,"Mar 31, 2017",Ghost in the Shell,110000000,40563557,167910690,57910690,52.64608181818182,-69436443,-63.12403909090909,tt1219827,35,CA,en
339,40,"Mar 31, 2017",Ghost in the Shell,110000000,40563557,167910690,57910690,52.64608181818182,-69436443,-63.12403909090909,tt1219827,37,IE,en
339,40,"Mar 31, 2017",Ghost in the Shell,110000000,40563557,167910690,57910690,52.64608181818182,-69436443,-63.12403909090909,tt4337072,9,XWW,en
345,46,"Oct 2, 2015",The Martian,108000000,228433663,655271443,547271443,506.7328175925926,120433663,111.51265092592593,tt3659388,41,CA,en
351,52,"Jul 22, 2016",Ice Age: Collision Course,105000000,64063008,402156682,297156682,283.0063638095238,-40936992,-38.98761142857143,tt3416828,1,CA,en
357,58,"Mar 9, 2018",A Wrinkle in Time,103000000,100478608,133401882,30401882,29.516390291262134,-2521392,-2.447953398058252,tt1620680,35,US,en
361,62,"Dec 21, 2018",Bumblebee,102000000,127195589,465195589,363195589,356.0741068627451,25195589,24.701557843137255,tt4701182,10,TH,en
361,62,"Dec 21, 2018",Bumblebee,102000000,127195589,465195589,363195589,356.0741068627451,25195589,24.701557843137255,tt4701182,11,IL,he
361,62,"Dec 21, 2018",Bumblebee,102000000,127195589,465195589,363195589,356.0741068627451,25195589,24.701557843137255,tt4701182,13,TR,tr
361,62,"Dec 21, 2018",Bumblebee,102000000,127195589,465195589,363195589,356.0741068627451,25195589,24.701557843137255,tt4701182,18,XWW,en
361,62,"Dec 21, 2018",Bumblebee,102000000,127195589,465195589,363195589,356.0741068627451,25195589,24.701557843137255,tt4701182,9,CA,fr
368,69,"Dec 25, 2012",Django Unchained,100000000,162805434,449948323,349948323,349.948323,62805434,62.805434000000005,tt1853728,18,LU,fr
375,76,"Dec 25, 2013",The Wolf of Wall Street,100000000,116900694,389870414,289870414,289.870414,16900694,16.900693999999998,tt0993846,14,IE,en
375,76,"Dec 25, 2013",The Wolf of Wall Street,100000000,116900694,389870414,289870414,289.870414,16900694,16.900693999999998,tt0993846,18,CA,en
375,76,"Dec 25, 2013",The Wolf of Wall Street,100000000,116900694,389870414,289870414,289.870414,16900694,16.900693999999998,tt0993846,6,NZ,en
383,84,"Jul 25, 2014",Hercules,100000000,72688614,243388614,143388614,143.388614,-27311386,-27.311386,tt1267297,29,IL,he
707,8,"Jun 13, 1997",Hercules,70000000,99112101,250700000,180700000,258.14285714285717,29112101,41.58871571428571,tt1267297,29,IL,he
393,94,"Mar 15, 2019",Wonder Park,100000000,45216793,115149422,15149422,15.149422000000001,-54783207,-54.783207,tt6428676,4,XWW,en
397,98,"Mar 12, 2010",Green Zone,100000000,35497337,97523020,-2476980,-2.47698,-64502663,-64.502663,tt0947810,24,JP,en
397,98,"Mar 12, 2010",Green Zone,100000000,35497337,97523020,-2476980,-2.47698,-64502663,-64.502663,tt0947810,3,US,en
399,100,"Dec 25, 2015",Point Break,100000000,28782481,126704591,26704591,26.704591,-71217519,-71.217519,tt2058673,27,TR,tr
2340,41,"Jul 12, 1991",Point Break,24000000,43218387,83531958,59531958,248.049825,19218387,80.0766125,tt2058673,27,TR,tr
401,2,"Apr 18, 2014",Transcendence,100000000,23022309,103039258,3039258,3.039258,-76977691,-76.97769100000001,tt2209764,7,CA,fr
406,7,"Nov 6, 2015",The Peanuts Movie,99000000,130178411,250091610,151091610,152.61778787878788,31178411,31.493344444444443,tt2452042,27,XWW,en
411,12,"May 19, 2017",Alien: Covenant,97000000,74262031,238521247,141521247,145.89819278350515,-22737969,-23.441205154639174,tt2316204,35,CA,fr
412,13,"Mar 13, 2015",Cinderella,95000000,201151353,534551353,439551353,462.68563473684213,106151353,111.73826631578947,tt1661199,28,IL,en
412,13,"Mar 13, 2015",Cinderella,95000000,201151353,534551353,439551353,462.68563473684213,106151353,111.73826631578947,tt6241270,6,TR,tr
4775,76,"Feb 15, 1950",Cinderella,2900000,85000000,263591415,260691415,8989.359137931035,82100000,2831.0344827586205,tt1661199,28,IL,en
4775,76,"Feb 15, 1950",Cinderella,2900000,85000000,263591415,260691415,8989.359137931035,82100000,2831.0344827586205,tt6241270,6,TR,tr
415,16,"May 27, 2010",Sex and the City 2,95000000,95347692,294680778,199680778,210.19029263157893,347692,0.3659915789473684,tt1261945,24,TR,tr
418,19,"Nov 12, 2010",Unstoppable,95000000,81562942,165720921,70720921,74.4430747368421,-13437058,-14.144271578947368,tt9225192,1,XWW,en
422,23,"Aug 19, 2016",Ben-Hur,95000000,26410477,91669648,-3330352,-3.505633684210526,-68589523,-72.19949789473684,tt2638144,10,CA,fr
3007,8,"Nov 18, 1959",Ben-Hur,15000000,73000000,73259017,58259017,388.39344666666665,58000000,386.6666666666667,tt2638144,10,CA,fr
428,29,"Feb 13, 2015",Kingsman: The Secret Service,94000000,128261724,404561724,310561724,330.38481276595746,34261724,36.44864255319149,tt2802144,2,CA,en
428,29,"Feb 13, 2015",Kingsman: The Secret Service,94000000,128261724,404561724,310561724,330.38481276595746,34261724,36.44864255319149,tt2802144,7,IE,en
430,31,"Aug 5, 2011",Rise of the Planet of the Apes,93000000,176760185,470986200,377986200,406.43677419354833,83760185,90.06471505376345,tt1318514,7,BE,qbn
445,46,"Apr 15, 2011",Rio,90000000,143619809,487519809,397519809,441.6886766666667,53619809,59.57756555555556,tt1436562,10,TR,tr
445,46,"Apr 15, 2011",Rio,90000000,143619809,487519809,397519809,441.6886766666667,53619809,59.57756555555556,tt1436562,13,US,en
445,46,"Apr 15, 2011",Rio,90000000,143619809,487519809,397519809,441.6886766666667,53619809,59.57756555555556,tt1436562,18,IL,he
445,46,"Apr 15, 2011",Rio,90000000,143619809,487519809,397519809,441.6886766666667,53619809,59.57756555555556,tt1436562,28,CA,fr
445,46,"Apr 15, 2011",Rio,90000000,143619809,487519809,397519809,441.6886766666667,53619809,59.57756555555556,tt1436562,3,XWW,en
450,51,"Dec 20, 2011",The Girl with the Dragon Tattoo,90000000,102515793,239373970,149373970,165.97107777777777,12515793,13.906436666666666,tt1568346,11,XWW,en
450,51,"Dec 20, 2011",The Girl with the Dragon Tattoo,90000000,102515793,239373970,149373970,165.97107777777777,12515793,13.906436666666666,tt1568346,39,US,en
455,56,"Dec 18, 2015",Alvin and the Chipmunks: The Road Chip,90000000,85886987,249517956,159517956,177.24217333333334,-4113013,-4.570014444444444,tt2974918,2,CA,en
458,59,"Jul 24, 2015",Pixels,90000000,78765986,244041804,154041804,171.15756,-11234014,-12.482237777777778,tt2120120,3,TR,tr
458,59,"Jul 24, 2015",Pixels,90000000,78765986,244041804,154041804,171.15756,-11234014,-12.482237777777778,tt2120120,7,CA,fr
458,59,"Jul 24, 2015",Pixels,90000000,78765986,244041804,154041804,171.15756,-11234014,-12.482237777777778,tt1664775,3,XWW,en
462,63,"Apr 22, 2005",The Interpreter,90000000,72708161,162753837,72753837,80.83759666666667,-17291839,-19.213154444444445,tt7368554,13,XWW,en
467,68,"Apr 4, 1997",The Saint,90000000,61363304,169400000,79400000,88.22222222222223,-28636696,-31.81855111111111,tt5846676,3,XWW,en
469,70,"Mar 16, 2018",Tomb Raider,90000000,58250803,273477501,183477501,203.86389,-31749197,-35.27688555555555,tt1365519,14,CA,en
469,70,"Mar 16, 2018",Tomb Raider,90000000,58250803,273477501,183477501,203.86389,-31749197,-35.27688555555555,tt1365519,26,CA,fr
469,70,"Mar 16, 2018",Tomb Raider,90000000,58250803,273477501,183477501,203.86389,-31749197,-35.27688555555555,tt1365519,3,IL,he
471,72,"Jul 7, 2004",King Arthur,90000000,51877963,203877963,113877963,126.53106999999999,-38122037,-42.357818888888886,tt1972591,11,IL,he
471,72,"Jul 7, 2004",King Arthur,90000000,51877963,203877963,113877963,126.53106999999999,-38122037,-42.357818888888886,tt1972591,33,JP,en
472,73,"Apr 25, 1997",Volcano,90000000,47546796,120100000,30100000,33.44444444444444,-42453204,-47.170226666666665,tt1695831,8,XWW,en
475,76,"Aug 19, 2011",Conan the Barbarian,90000000,21295021,63356133,-26643867,-29.60429666666667,-68704979,-76.33886555555556,tt0816462,8,CA,en
2543,44,"May 14, 1982",Conan the Barbarian,20000000,38264085,79114085,59114085,295.570425,18264085,91.320425,tt0816462,8,CA,en
477,78,"Apr 21, 2017",The Promise,90000000,8224288,10551417,-79448583,-88.27620333333334,-81775712,-90.86190222222223,tt7232438,4,XWW,en
477,78,"Apr 21, 2017",The Promise,90000000,8224288,10551417,-79448583,-88.27620333333334,-81775712,-90.86190222222223,tt4552298,3,XWW,en
477,78,"Apr 21, 2017",The Promise,90000000,8224288,10551417,-79448583,-88.27620333333334,-81775712,-90.86190222222223,tt4532628,1,XWW,en
478,79,"Nov 24, 2010",The Nutcracker in 3D,90000000,195459,20466016,-69533984,-77.25998222222222,-89804541,-99.78282333333334,tt1041804,14,XWW,en
496,97,"Apr 5, 2019",Shazam!,85000000,139606856,362899733,277899733,326.9408623529412,54606856,64.24336000000001,tt0448115,7,IL,he
498,99,"Feb 10, 2012",Safe House,85000000,126181630,208542162,123542162,145.34372,41181630,48.448976470588235,tt1599348,1,CA,en
503,4,"Sep 29, 2006",Open Season,85000000,85105259,191932158,106932158,125.8025388235294,105259,0.12383411764705882,tt8984382,1,XEU,en
504,5,"Nov 4, 2011",Tower Heist,85000000,78046570,150422946,65422946,76.96817176470589,-6953430,-8.180505882352941,tt0471042,5,CA,en
514,15,"Jan 20, 2017",xXx: Return of Xander Cage,85000000,44898413,345033359,260033359,305.9215988235294,-40101587,-47.17833764705882,tt1293847,27,CA,en
518,19,"Mar 15, 2002",Showtime,85000000,37948765,78948765,-6051235,-7.1191,-47051235,-55.354394117647054,tt1720297,1,XWW,en
519,20,"Jun 30, 1995",Judge Dredd,85000000,34687912,113487912,28487912,33.51519058823529,-50312088,-59.19069176470588,tt1343727,11,JP,en
519,20,"Jun 30, 1995",Judge Dredd,85000000,34687912,113487912,28487912,33.51519058823529,-50312088,-59.19069176470588,tt1343727,25,JM,en
523,24,"May 9, 1997",Father's Day,85000000,28681080,35681080,-49318920,-58.02225882352941,-56318920,-66.25755294117647,tt4003682,3,XWW,en
523,24,"May 9, 1997",Father's Day,85000000,28681080,35681080,-49318920,-58.02225882352941,-56318920,-66.25755294117647,tt4003682,4,IN,en
527,28,"Jul 19, 2013",RED 2,84000000,53262560,141507355,57507355,68.46113690476191,-30737440,-36.59219047619048,tt1821694,25,FI,sv
527,28,"Jul 19, 2013",RED 2,84000000,53262560,141507355,57507355,68.46113690476191,-30737440,-36.59219047619048,tt1821694,26,IL,he
527,28,"Jul 19, 2013",RED 2,84000000,53262560,141507355,57507355,68.46113690476191,-30737440,-36.59219047619048,tt1821694,27,TR,tr
537,38,"Mar 23, 2012",The Hunger Games,80000000,408010692,677923379,597923379,747.40422375,328010692,410.013365,tt1392170,3,CA,en
540,41,"Feb 10, 2017",The Lego Batman Movie,80000000,175750384,310660018,230660018,288.3250225,95750384,119.68798000000001,tt4116284,14,US,en
551,52,"Feb 19, 2010",Shutter Island,80000000,128012934,299461782,219461782,274.3272275,48012934,60.016167499999995,tt1130884,22,JP,en
551,52,"Feb 19, 2010",Shutter Island,80000000,128012934,299461782,219461782,274.3272275,48012934,60.016167499999995,tt1130884,27,CA,fr
551,52,"Feb 19, 2010",Shutter Island,80000000,128012934,299461782,219461782,274.3272275,48012934,60.016167499999995,tt1130884,8,CA,en
563,64,"Jan 15, 2010",The Book of Eli,80000000,94835059,158750817,78750817,98.43852125,14835059,18.543823749999998,tt1037705,22,CA,en
567,68,"Oct 17, 2014",Fury,80000000,85817906,210315681,130315681,162.89460125,5817906,7.272382500000001,tt1867093,14,GB,en
567,68,"Oct 17, 2014",Fury,80000000,85817906,210315681,130315681,162.89460125,5817906,7.272382500000001,tt2713180,28,CA,en
567,68,"Oct 17, 2014",Fury,80000000,85817906,210315681,130315681,162.89460125,5817906,7.272382500000001,tt2713180,5,TR,tr
588,89,"Jun 8, 2001",Evolution,80000000,38311134,98341932,18341932,22.927415,-41688866,-52.11108250000001,tt4291590,10,XWW,en
594,95,"Dec 6, 1996",Daylight,80000000,32908290,158908290,78908290,98.6353625,-47091710,-58.86463750000001,tt2359002,1,XWW,en
596,97,"Feb 21, 2014",Pompeii,80000000,23169033,108469033,28469033,35.58629125,-56830967,-71.03870875,tt1921064,12,IL,he
596,97,"Feb 21, 2014",Pompeii,80000000,23169033,108469033,28469033,35.58629125,-56830967,-71.03870875,tt1921064,13,TR,tr
599,100,"Dec 18, 2009",Nine,80000000,19676965,53508858,-26491142,-33.1139275,-60323035,-75.40379375,tt8180482,2,XWW,en
618,19,"Feb 12, 2016",The Little Prince,77500000,1311213,102028919,24528919,31.650218064516128,-76188787,-98.30811225806451,tt1754656,32,XWW,en
625,26,"Jul 8, 2016",The Secret Life of Pets,75000000,368384330,886750534,811750534,1082.3340453333333,293384330,391.1791066666667,tt2709768,11,CA,en
642,43,"Aug 3, 2018",Christopher Robin,75000000,99215042,197504758,122504758,163.33967733333336,24215042,32.28672266666667,tt4575576,13,ES,es
642,43,"Aug 3, 2018",Christopher Robin,75000000,99215042,197504758,122504758,163.33967733333336,24215042,32.28672266666667,tt4575576,18,PT,pt
642,43,"Aug 3, 2018",Christopher Robin,75000000,99215042,197504758,122504758,163.33967733333336,24215042,32.28672266666667,tt4575576,23,IL,he
642,43,"Aug 3, 2018",Christopher Robin,75000000,99215042,197504758,122504758,163.33967733333336,24215042,32.28672266666667,tt4575576,29,TH,en
642,43,"Aug 3, 2018",Christopher Robin,75000000,99215042,197504758,122504758,163.33967733333336,24215042,32.28672266666667,tt4575576,34,DE,de
642,43,"Aug 3, 2018",Christopher Robin,75000000,99215042,197504758,122504758,163.33967733333336,24215042,32.28672266666667,tt4575576,9,US,en
650,51,"Apr 16, 1999",Life,75000000,64062587,73521587,-1478413,-1.9712173333333332,-10937413,-14.583217333333334,tt2948840,6,TR,tr
965,66,"Mar 24, 2017",Life,58000000,30234022,100929666,42929666,74.01666551724138,-27765978,-47.872375862068964,tt2948840,6,TR,tr
661,62,"Mar 25, 2011",Sucker Punch,75000000,36392502,89758389,14758389,19.677852,-38607498,-51.47666400000001,tt0978764,3,TR,tr
662,63,"Mar 11, 2005",Hostage,75000000,34636443,77636443,2636443,3.5152573333333335,-40363557,-53.818076000000005,tt1772292,2,US,en
662,63,"Mar 11, 2005",Hostage,75000000,34636443,77636443,2636443,3.5152573333333335,-40363557,-53.818076000000005,tt1772292,4,XWW,en
662,63,"Mar 11, 2005",Hostage,75000000,34636443,77636443,2636443,3.5152573333333335,-40363557,-53.818076000000005,tt3212738,7,XWW,en
663,64,"Oct 28, 2016",Inferno,75000000,34343574,219519367,144519367,192.69248933333333,-40656426,-54.208568,tt1686470,2,XWW,en
663,64,"Oct 28, 2016",Inferno,75000000,34343574,219519367,144519367,192.69248933333333,-40656426,-54.208568,tt3062096,19,CA,fr
668,69,"Jan 15, 1999",Virus,75000000,14010690,30626690,-44373310,-59.16441333333333,-60989310,-81.31908,tt8941440,2,IN,hi
676,77,"May 20, 2016",The Angry Birds Movie,73000000,107509366,352327887,279327887,382.6409410958904,34509366,47.27310410958904,tt1985949,16,US,en
676,77,"May 20, 2016",The Angry Birds Movie,73000000,107509366,352327887,279327887,382.6409410958904,34509366,47.27310410958904,tt1985949,22,XWW,en
676,77,"May 20, 2016",The Angry Birds Movie,73000000,107509366,352327887,279327887,382.6409410958904,34509366,47.27310410958904,tt1985949,2,GB,en
708,9,"Mar 22, 2013",Olympus Has Fallen,70000000,98927592,172878928,102878928,146.96989714285715,28927592,41.325131428571424,tt2302755,7,CA,en
711,12,"Dec 25, 2011",War Horse,70000000,79883359,156815529,86815529,124.02218428571427,9883359,14.119084285714287,tt1568911,5,CA,en
713,14,"Feb 7, 2014",The Monuments Men,70000000,78031620,158702748,88702748,126.71821142857142,8031620,11.473742857142858,tt2177771,13,CA,en
717,18,"Jun 17, 1994",Wolf,70000000,65011757,131011757,61011757,87.15965285714286,-4988243,-7.126061428571429,tt2112194,3,XWW,en
717,18,"Jun 17, 1994",Wolf,70000000,65011757,131011757,61011757,87.15965285714286,-4988243,-7.126061428571429,tt3540136,14,HK,en
717,18,"Jun 17, 1994",Wolf,70000000,65011757,131011757,61011757,87.15965285714286,-4988243,-7.126061428571429,tt6843284,1,TR,tr
717,18,"Jun 17, 1994",Wolf,70000000,65011757,131011757,61011757,87.15965285714286,-4988243,-7.126061428571429,tt8197998,4,XWW,en
718,19,"Jan 20, 2012",Underworld: Awakening,70000000,62321039,160379930,90379930,129.11418571428572,-7678961,-10.969944285714286,tt1496025,18,XWW,en
721,22,"Sep 29, 2006",The Guardian,70000000,55011732,94973540,24973540,35.67648571428572,-14988268,-21.41181142857143,tt2524172,4,XWW,en
721,22,"Sep 29, 2006",The Guardian,70000000,55011732,94973540,24973540,35.67648571428572,-14988268,-21.41181142857143,tt7146054,2,XWW,en
726,27,"Nov 6, 1998",The Siege,70000000,40934175,116625798,46625798,66.60828285714285,-29065825,-41.52260714285714,tt2318579,3,XWW,en
736,37,"Oct 18, 2013",Escape Plan,70000000,25135965,103735965,33735965,48.19423571428572,-44864035,-64.09147857142857,tt3652616,8,IN,en
736,37,"Oct 18, 2013",Escape Plan,70000000,25135965,103735965,33735965,48.19423571428572,-44864035,-64.09147857142857,tt5003186,5,XWW,en
737,38,"Sep 23, 2011",Killer Elite,70000000,25124986,65409046,-4590954,-6.558505714285714,-44875014,-64.10716285714285,tt1448755,3,TR,tr
746,47,"Jan 16, 2015",Blackhat,70000000,8005980,19665004,-50334996,-71.90713714285715,-61994020,-88.56288571428571,tt2717822,23,IL,he
749,50,"Jul 9, 2010",Despicable Me,69000000,251513985,543464573,474464573,687.6298159420289,182513985,264.51302173913047,tt1323594,4,IL,en
754,55,"Jun 26, 2015",Ted 2,68000000,81476385,217214143,149214143,219.4325632352941,13476385,19.81821323529412,tt2637276,14,IL,he
754,55,"Jun 26, 2015",Ted 2,68000000,81476385,217214143,149214143,219.4325632352941,13476385,19.81821323529412,tt2637276,20,CA,en
754,55,"Jun 26, 2015",Ted 2,68000000,81476385,217214143,149214143,219.4325632352941,13476385,19.81821323529412,tt2637276,9,CA,fr
769,70,"Mar 14, 2014",Need for Speed,66000000,43568507,194169619,128169619,194.19639242424242,-22431493,-33.987110606060604,tt2369135,2,CA,fr
771,72,"Dec 15, 2000",What Women Want,65000000,182805123,374105123,309105123,475.54634307692305,117805123,181.2386507692308,tt1667150,6,XWW,en
772,73,"Nov 9, 2012",Lincoln,65000000,182207973,273346281,208346281,320.53274,117207973,180.31995846153845,tt0443272,15,LU,fr
772,73,"Nov 9, 2012",Lincoln,65000000,182207973,273346281,208346281,320.53274,117207973,180.31995846153845,tt0443272,19,FI,sv
772,73,"Nov 9, 2012",Lincoln,65000000,182207973,273346281,208346281,320.53274,117207973,180.31995846153845,tt0443272,20,IL,he
772,73,"Nov 9, 2012",Lincoln,65000000,182207973,273346281,208346281,320.53274,117207973,180.31995846153845,tt0443272,21,TR,tr
773,74,"Mar 15, 2002",Ice Age,65000000,176387405,386116343,321116343,494.0251430769231,111387405,171.36523846153847,tt4418168,4,XWW,en
788,89,"Dec 19, 2014",Annie,65000000,85911262,139829625,74829625,115.12249999999999,20911262,32.17117230769231,tt1823664,14,IL,he
788,89,"Dec 19, 2014",Annie,65000000,85911262,139829625,74829625,115.12249999999999,20911262,32.17117230769231,tt1823664,2,TR,tr
793,94,"Jul 7, 2000",The Kid,65000000,69688384,69688384,4688384,7.212898461538461,4688384,7.212898461538461,tt3257450,3,XEU,en
793,94,"Jul 7, 2000",The Kid,65000000,69688384,69688384,4688384,7.212898461538461,4688384,7.212898461538461,tt4975920,7,XWW,en
793,94,"Jul 7, 2000",The Kid,65000000,69688384,69688384,4688384,7.212898461538461,4688384,7.212898461538461,tt4975920,9,US,en
798,99,"Feb 27, 2015",Focus,65000000,53862963,168065700,103065700,158.56261538461538,-11137037,-17.133903076923076,tt2381941,11,IL,he
798,99,"Feb 27, 2015",Focus,65000000,53862963,168065700,103065700,158.56261538461538,-11137037,-17.133903076923076,tt2381941,4,CA,fr
802,3,"Sep 18, 2015",Everest,65000000,43482270,221297061,156297061,240.4570169230769,-21517730,-33.1042,tt2719848,17,TR,tr
802,3,"Sep 18, 2015",Everest,65000000,43482270,221297061,156297061,240.4570169230769,-21517730,-33.1042,tt2719848,21,CA,fr
802,3,"Sep 18, 2015",Everest,65000000,43482270,221297061,156297061,240.4570169230769,-21517730,-33.1042,tt2719848,8,IL,he
803,4,"Sep 14, 2012",Resident Evil: Retribution,65000000,42345531,240647629,175647629,270.2271215384616,-22654469,-34.85302923076923,tt1855325,16,JP,en
803,4,"Sep 14, 2012",Resident Evil: Retribution,65000000,42345531,240647629,175647629,270.2271215384616,-22654469,-34.85302923076923,tt1855325,7,IE,en
810,11,"Nov 26, 2003",The Missing,65000000,26900336,38253433,-26746567,-41.148564615384615,-38099664,-58.61486769230769,tt4823122,1,XWW,en
815,16,"Aug 22, 2014",Sin City: A Dame to Kill For,65000000,13757804,40650842,-24349158,-37.46024307692308,-51242196,-78.83414769230768,tt0458481,11,CA,en
820,21,"Oct 26, 2018",Air Strike,65000000,0,516279,-64483721,-99.20572461538461,-65000000,-100.0,tt4743226,5,US,en
821,22,"Jul 14, 2006",Little Man,64000000,58636047,101636047,37636047,58.8063234375,-5363953,-8.3811765625,tt2458724,1,XWW,en
826,27,"Apr 1, 2011",Hop,63000000,108085305,188657593,125657593,199.45649682539684,45085305,71.56397619047618,tt1411704,18,TR,tr
827,28,"Sep 15, 2017",American Assassin,63000000,36249674,68310140,5310140,8.42879365079365,-26750326,-42.46083492063492,tt1961175,24,MY,en
837,38,"Sep 18, 2015",Maze Runner: The Scorch Trials,61000000,81697192,310566162,249566162,409.12485573770493,20697192,33.92982295081967,tt4046784,30,CA,en
839,40,"Jan 26, 2018",Maze Runner: The Death Cure,61000000,58032443,265878536,204878536,335.8664524590164,-2967557,-4.8648475409836065,tt4500922,33,XWW,en
849,50,"Sep 9, 2016",Sully,60000000,125070033,238524556,178524556,297.5409266666667,65070033,108.450055,tt3263904,17,FI,sv
849,50,"Sep 9, 2016",Sully,60000000,125070033,238524556,178524556,297.5409266666667,65070033,108.450055,tt3263904,18,IL,he
849,50,"Sep 9, 2016",Sully,60000000,125070033,238524556,178524556,297.5409266666667,65070033,108.450055,tt3263904,29,CA,fr
862,63,"Oct 15, 2010",Red,60000000,90380162,196439693,136439693,227.39948833333332,30380162,50.63360333333333,tt1245526,20,TR,tr
862,63,"Oct 15, 2010",Red,60000000,90380162,196439693,136439693,227.39948833333332,30380162,50.63360333333333,tt1245526,22,FI,sv
867,68,"Dec 21, 2012",Jack Reacher,60000000,80070736,217370736,157370736,262.28456,20070736,33.45122666666667,tt0790724,17,CA,en
867,68,"Dec 21, 2012",Jack Reacher,60000000,80070736,217370736,157370736,262.28456,20070736,33.45122666666667,tt0790724,28,TR,tr
867,68,"Dec 21, 2012",Jack Reacher,60000000,80070736,217370736,157370736,262.28456,20070736,33.45122666666667,tt0790724,31,IL,he
867,68,"Dec 21, 2012",Jack Reacher,60000000,80070736,217370736,157370736,262.28456,20070736,33.45122666666667,tt0790724,5,CA,fr
879,80,"Mar 4, 2016",London Has Fallen,60000000,62524260,195194085,135194085,225.32347499999997,2524260,4.2071,tt3300542,1,CA,en
883,84,"Apr 2, 2004",Hellboy,60000000,59623958,99823958,39823958,66.37326333333333,-376042,-0.6267366666666667,tt2274648,12,TR,tr
883,84,"Apr 2, 2004",Hellboy,60000000,59623958,99823958,39823958,66.37326333333333,-376042,-0.6267366666666667,tt2274648,17,CA,fr
1176,77,"Apr 12, 2019",Hellboy,50000000,21903748,40725492,-9274508,-18.549015999999998,-28096252,-56.192504,tt2274648,12,TR,tr
1176,77,"Apr 12, 2019",Hellboy,50000000,21903748,40725492,-9274508,-18.549015999999998,-28096252,-56.192504,tt2274648,17,CA,fr
887,88,"Dec 25, 2015",Joy,60000000,56451232,101134059,41134059,68.556765,-3548768,-5.9146133333333335,tt2495188,3,XWW,en
887,88,"Dec 25, 2015",Joy,60000000,56451232,101134059,41134059,68.556765,-3548768,-5.9146133333333335,tt2446980,16,CA,fr
887,88,"Dec 25, 2015",Joy,60000000,56451232,101134059,41134059,68.556765,-3548768,-5.9146133333333335,tt2446980,2,IL,he
888,89,"Aug 17, 2012",ParaNorman,60000000,56003051,108119662,48119662,80.19943666666667,-3996949,-6.661581666666666,tt1623288,13,IL,he
888,89,"Aug 17, 2012",ParaNorman,60000000,56003051,108119662,48119662,80.19943666666667,-3996949,-6.661581666666666,tt1623288,19,TR,tr
888,89,"Aug 17, 2012",ParaNorman,60000000,56003051,108119662,48119662,80.19943666666667,-3996949,-6.661581666666666,tt1623288,1,CA,fr
896,97,"Jan 17, 2014",Jack Ryan: Shadow Recruit,60000000,50577412,131377412,71377412,118.96235333333334,-9422588,-15.704313333333333,tt1205537,5,CA,en
899,100,"Dec 25, 2018",Vice,60000000,47836282,70883171,10883171,18.138618333333334,-12163718,-20.272863333333333,tt3480796,19,TR,tr
899,100,"Dec 25, 2018",Vice,60000000,47836282,70883171,10883171,18.138618333333334,-12163718,-20.272863333333333,tt3480796,9,CA,fr
899,100,"Dec 25, 2018",Vice,60000000,47836282,70883171,10883171,18.138618333333334,-12163718,-20.272863333333333,tt6266538,10,CA,fr
904,5,"Apr 7, 2017",Smurfs: The Lost Village,60000000,45020282,197578586,137578586,229.29764333333333,-14979718,-24.96619666666667,tt2398241,26,CA,en
921,22,"Sep 15, 2000",Almost Famous,60000000,32522352,47371191,-12628809,-21.048015,-27477648,-45.79608,tt7059806,3,XWW,en
921,22,"Sep 15, 2000",Almost Famous,60000000,32522352,47371191,-12628809,-21.048015,-27477648,-45.79608,tt7059806,5,IL,en
922,23,"Feb 8, 2019",Cold Pursuit,60000000,32138862,62599159,2599159,4.331931666666667,-27861138,-46.43523,tt5719748,28,GB,en
922,23,"Feb 8, 2019",Cold Pursuit,60000000,32138862,62599159,2599159,4.331931666666667,-27861138,-46.43523,tt5719748,5,XWW,en
940,41,"Jan 14, 2000",Supernova,60000000,14218868,14816494,-45183506,-75.30584333333333,-45781132,-76.30188666666666,tt4231466,4,ID,id
947,48,"Jan 23, 2015",Mortdecai,60000000,7696134,30396134,-29603866,-49.339776666666666,-52303866,-87.17311,tt3045616,20,CA,fr
953,54,"Mar 23, 2018",Sherlock Gnomes,59000000,43242871,87527651,28527651,48.35195084745762,-15757129,-26.706998305084745,tt2296777,9,CA,fr
954,55,"Jan 25, 2019",The Kid Who Would Be King,59000000,16790790,28348446,-30651554,-51.951786440677964,-42209210,-71.54103389830509,tt6811018,20,GB,en
954,55,"Jan 25, 2019",The Kid Who Would Be King,59000000,16790790,28348446,-30651554,-51.951786440677964,-42209210,-71.54103389830509,tt6811018,2,XWW,en
955,56,"Feb 12, 2016",Deadpool,58000000,363070709,801025593,743025593,1281.0786086206897,305070709,525.9839810344827,tt1431045,14,CA,fr
955,56,"Feb 12, 2016",Deadpool,58000000,363070709,801025593,743025593,1281.0786086206897,305070709,525.9839810344827,tt1431045,1,XWW,en
955,56,"Feb 12, 2016",Deadpool,58000000,363070709,801025593,743025593,1281.0786086206897,305070709,525.9839810344827,tt1431045,6,US,en
955,56,"Feb 12, 2016",Deadpool,58000000,363070709,801025593,743025593,1281.0786086206897,305070709,525.9839810344827,tt1431045,7,IL,he
956,57,"Dec 25, 2014",American Sniper,58000000,350126372,547326372,489326372,843.6661586206898,292126372,503.66615862068966,tt2179136,12,CA,en
957,58,"Oct 16, 2015",Goosebumps,58000000,80069458,158905324,100905324,173.97469655172412,22069458,38.05078965517241,tt1051904,13,CA,en
957,58,"Oct 16, 2015",Goosebumps,58000000,80069458,158905324,100905324,173.97469655172412,22069458,38.05078965517241,tt1051904,14,IE,en
969,70,"Sep 10, 2010",Resident Evil: Afterlife,57500000,60128566,295874190,238374190,414.5638086956522,2628566,4.571419130434783,tt1220634,10,IE,en
970,71,"Jun 15, 2012",That's My Boy,57500000,36931089,58085235,585235,1.0178,-20568911,-35.772019130434785,tt1232200,32,JP,en
973,74,"May 31, 1996",Dragonheart,57000000,51364680,104364680,47364680,83.0959298245614,-5635320,-9.886526315789473,tt6126328,3,XWW,en
976,77,"Dec 25, 2014",Into the Woods,56200000,128002372,213116401,156916401,279.21067793594307,71802372,127.76222775800711,tt2180411,1,NZ,en
983,84,"Nov 2, 2018",Bohemian Rhapsody,55000000,216303339,894985342,839985342,1527.2460763636363,161303339,293.27879818181816,tt1727824,12,TR,tr
983,84,"Nov 2, 2018",Bohemian Rhapsody,55000000,216303339,894985342,839985342,1527.2460763636363,161303339,293.27879818181816,tt1727824,17,XWW,en
983,84,"Nov 2, 2018",Bohemian Rhapsody,55000000,216303339,894985342,839985342,1527.2460763636363,161303339,293.27879818181816,tt1727824,27,HK,en
983,84,"Nov 2, 2018",Bohemian Rhapsody,55000000,216303339,894985342,839985342,1527.2460763636363,161303339,293.27879818181816,tt1727824,29,CA,en
983,84,"Nov 2, 2018",Bohemian Rhapsody,55000000,216303339,894985342,839985342,1527.2460763636363,161303339,293.27879818181816,tt1727824,5,CA,fr
983,84,"Nov 2, 2018",Bohemian Rhapsody,55000000,216303339,894985342,839985342,1527.2460763636363,161303339,293.27879818181816,tt1727824,6,GB,en
991,92,"Oct 11, 2013",Captain Phillips,55000000,107136417,220648184,165648184,301.1785163636364,52136417,94.79348545454546,tt1535109,6,CA,en
995,96,"Sep 26, 2014",The Equalizer,55000000,101530738,192903624,137903624,250.7338618181818,46530738,84.60134181818182,tt0455944,21,XWW,en
995,96,"Sep 26, 2014",The Equalizer,55000000,101530738,192903624,137903624,250.7338618181818,46530738,84.60134181818182,tt0455944,30,US,en
1004,5,"Jan 16, 2015",Paddington,55000000,76223578,258789097,203789097,370.5256309090909,21223578,38.58832363636363,tt1109624,18,CA,fr
1019,20,"Mar 21, 2014",Muppets Most Wanted,55000000,51178893,79312301,24312301,44.20418363636364,-3821107,-6.947467272727273,tt2281587,26,XWW,en
1023,24,"Nov 24, 2010",Burlesque,55000000,39440655,90552675,35552675,64.64122727272728,-15559345,-28.28971818181818,tt1126591,11,CA,fr
1023,24,"Nov 24, 2010",Burlesque,55000000,39440655,90552675,35552675,64.64122727272728,-15559345,-28.28971818181818,tt1126591,27,IL,he
1031,32,"Feb 23, 2018",Annihilation,55000000,32732301,43070915,-11929085,-21.689245454545457,-22267699,-40.48672545454545,tt2798920,17,CA,fr
1032,33,"Oct 16, 2015",Crimson Peak,55000000,31090320,74966854,19966854,36.30337090909091,-23909680,-43.472145454545455,tt2554274,1,IL,he
1032,33,"Oct 16, 2015",Crimson Peak,55000000,31090320,74966854,19966854,36.30337090909091,-23909680,-43.472145454545455,tt2554274,24,CA,fr
1033,34,"Apr 27, 2012",The Pirates! Band of Misfits,55000000,31051126,136143605,81143605,147.53382727272728,-23948874,-43.54340727272727,tt1430626,28,GB,en
1033,34,"Apr 27, 2012",The Pirates! Band of Misfits,55000000,31051126,136143605,81143605,147.53382727272728,-23948874,-43.54340727272727,tt1430626,3,XWW,en
1033,34,"Apr 27, 2012",The Pirates! Band of Misfits,55000000,31051126,136143605,81143605,147.53382727272728,-23948874,-43.54340727272727,tt1430626,8,CA,en
1035,36,"Aug 2, 1996",Chain Reaction,55000000,21226204,60209334,5209334,9.471516363636363,-33773796,-61.406901818181815,tt7201536,2,XWW,en
1040,41,"Jan 10, 1997",Turbulence,55000000,11532774,11532774,-43467226,-79.03132000000001,-43467226,-79.03132000000001,tt2118761,2,XWW,en
1059,60,"Nov 14, 1997",Anastasia,53000000,58403409,139801096,86801096,163.77565283018868,5403409,10.195111320754718,tt7014356,11,IN,en
1059,60,"Nov 14, 1997",Anastasia,53000000,58403409,139801096,86801096,163.77565283018868,5403409,10.195111320754718,tt7014356,13,IN,bn
1059,60,"Nov 14, 1997",Anastasia,53000000,58403409,139801096,86801096,163.77565283018868,5403409,10.195111320754718,tt7014356,17,XWW,en
1059,60,"Nov 14, 1997",Anastasia,53000000,58403409,139801096,86801096,163.77565283018868,5403409,10.195111320754718,tt7014356,5,BD,bn
1059,60,"Nov 14, 1997",Anastasia,53000000,58403409,139801096,86801096,163.77565283018868,5403409,10.195111320754718,tt7014356,7,PK,ur
1059,60,"Nov 14, 1997",Anastasia,53000000,58403409,139801096,86801096,163.77565283018868,5403409,10.195111320754718,tt7014356,8,US,en
1060,61,"May 18, 2001",Moulin Rouge,53000000,57386369,179200588,126200588,238.11431698113208,4386369,8.276167924528302,tt2061758,2,XWW,en
1064,65,"Oct 16, 1998",Beloved,53000000,22852487,22852487,-30147513,-56.8821,-30147513,-56.8821,tt1410297,4,XWW,en
1064,65,"Oct 16, 1998",Beloved,53000000,22852487,22852487,-30147513,-56.8821,-30147513,-56.8821,tt1815799,16,XWW,en
1064,65,"Oct 16, 1998",Beloved,53000000,22852487,22852487,-30147513,-56.8821,-30147513,-56.8821,tt3421854,3,XWW,en
1065,66,"Dec 19, 2012",Zero Dark Thirty,52500000,95720716,134612435,82112435,156.4046380952381,43220716,82.32517333333334,tt1790885,25,CA,en
1065,66,"Dec 19, 2012",Zero Dark Thirty,52500000,95720716,134612435,82112435,156.4046380952381,43220716,82.32517333333334,tt1790885,3,LU,fr
1069,70,"Feb 12, 2010",Valentine's Day,52000000,110485654,217569328,165569328,318.40255384615386,58485654,112.47241153846154,tt5529120,1,XWW,en
1078,79,"Aug 17, 2018",Alpha,51000000,35851379,99624873,48624873,95.34288823529413,-15148621,-29.70317843137255,tt4244998,20,CA,fr
1083,84,"Jun 29, 2012",Ted,50000000,218665740,556016627,506016627,1012.0332539999999,168665740,337.33148,tt1637725,11,CA,en
1083,84,"Jun 29, 2012",Ted,50000000,218665740,556016627,506016627,1012.0332539999999,168665740,337.33148,tt1637725,16,IL,he
1083,84,"Jun 29, 2012",Ted,50000000,218665740,556016627,506016627,1012.0332539999999,168665740,337.33148,tt1637725,25,CA,fr
1084,85,"Jun 13, 2014",22 Jump Street,50000000,191719337,331333876,281333876,562.6677520000001,141719337,283.438674,tt2294449,7,CA,fr
1090,91,"Jun 17, 2016",Central Intelligence,50000000,127440871,217194805,167194805,334.38961,77440871,154.881742,tt1489889,22,CA,en
1092,93,"Jun 10, 2011",Super 8,50000000,127004179,257972745,207972745,415.94549,77004179,154.008358,tt1650062,12,CA,fr
1092,93,"Jun 10, 2011",Super 8,50000000,127004179,257972745,207972745,415.94549,77004179,154.008358,tt1650062,28,US,en
1092,93,"Jun 10, 2011",Super 8,50000000,127004179,257972745,207972745,415.94549,77004179,154.008358,tt1650062,2,TR,tr
1092,93,"Jun 10, 2011",Super 8,50000000,127004179,257972745,207972745,415.94549,77004179,154.008358,tt1650062,8,IL,he
1095,96,"Nov 21, 2018",Creed II,50000000,115715889,213591522,163591522,327.183044,65715889,131.431778,tt6343314,12,CA,fr
1096,97,"Feb 9, 2018",Peter Rabbit,50000000,115234093,347136477,297136477,594.272954,65234093,130.468186,tt5117670,21,IL,he
1099,100,"Dec 14, 2018",The Mule,50000000,103804407,170857676,120857676,241.715352,53804407,107.608814,tt2069955,7,NZ,en
1099,100,"Dec 14, 2018",The Mule,50000000,103804407,170857676,120857676,241.715352,53804407,107.608814,tt0804509,3,XWW,en
1101,2,"Feb 28, 2014",Non-Stop,50000000,91742160,222383055,172383055,344.76610999999997,41742160,83.48432,tt2024469,10,TR,tr
1101,2,"Feb 28, 2014",Non-Stop,50000000,91742160,222383055,172383055,344.76610999999997,41742160,83.48432,tt2024469,13,IL,he
1101,2,"Feb 28, 2014",Non-Stop,50000000,91742160,222383055,172383055,344.76610999999997,41742160,83.48432,tt2024469,25,ES,ca
1108,9,"Dec 22, 2017",The Post,50000000,81903458,179748880,129748880,259.49775999999997,31903458,63.806916,tt6294822,39,TR,tr
1114,15,"Sep 23, 2011",Moneyball,50000000,75605492,111300835,61300835,122.60167,25605492,51.210984,tt1210166,21,IL,en
1131,32,"Sep 29, 2017",American Made,50000000,51342000,135569212,85569212,171.138424,1342000,2.6839999999999997,tt3532216,6,CA,en
1137,38,"Sep 12, 1997",The Game,50000000,48265581,80369970,30369970,60.739940000000004,-1734419,-3.468838,tt7489816,7,XWW,en
1140,41,"Oct 10, 2014",The Judge,50000000,47119388,76119388,26119388,52.238776,-2880612,-5.761224,tt6040662,10,XEU,en
1158,59,"Jun 4, 2010",Marmaduke,50000000,33644788,89895930,39895930,79.79186,-16355212,-32.710423999999996,tt1392197,13,CA,fr
1163,64,"Feb 12, 2016",Zoolander 2,50000000,28848693,55348693,5348693,10.697386,-21151307,-42.302614,tt1608290,17,IL,he
1163,64,"Feb 12, 2016",Zoolander 2,50000000,28848693,55348693,5348693,10.697386,-21151307,-42.302614,tt1608290,6,CA,fr
1163,64,"Feb 12, 2016",Zoolander 2,50000000,28848693,55348693,5348693,10.697386,-21151307,-42.302614,tt1608290,7,CA,en
1173,74,"Feb 27, 2004",Twisted,50000000,25195050,40119848,-9880152,-19.760304,-24804950,-49.6099,tt1996436,3,SG,en
1173,74,"Feb 27, 2004",Twisted,50000000,25195050,40119848,-9880152,-19.760304,-24804950,-49.6099,tt2569778,2,CA,en
1178,79,"Sep 16, 2016",Snowden,50000000,21587519,35380918,-14619082,-29.238164,-28412481,-56.824962,tt3774114,3,CA,fr
1181,82,"Sep 4, 2009",Gamer,50000000,20534907,42002029,-7997971,-15.995942,-29465093,-58.93018599999999,tt2217809,2,XWW,en
1193,94,"Oct 14, 2005",Domino,50000000,10169202,23574057,-26425943,-52.851886,-39830798,-79.661596,tt3282076,1,IL,he
1203,4,"Mar 15, 2013",Upside Down,50000000,102118,26387039,-23612961,-47.225922,-49897882,-99.79576399999999,tt2271287,6,XEU,en
1203,4,"Mar 15, 2013",Upside Down,50000000,102118,26387039,-23612961,-47.225922,-49897882,-99.79576399999999,tt2044734,2,XWW,en
1209,10,"Nov 2, 2001",The One,49000000,43905746,72689126,23689126,48.34515510204081,-5094254,-10.396436734693877,tt7121588,4,XWW,en
1210,11,"Mar 6, 2015",Chappie,49000000,31569268,105002056,56002056,114.28991020408164,-17430732,-35.5729224489796,tt1823672,17,CA,fr
1210,11,"Mar 6, 2015",Chappie,49000000,31569268,105002056,56002056,114.28991020408164,-17430732,-35.5729224489796,tt1823672,19,CA,en
1210,11,"Mar 6, 2015",Chappie,49000000,31569268,105002056,56002056,114.28991020408164,-17430732,-35.5729224489796,tt1823672,20,TR,tr
1210,11,"Mar 6, 2015",Chappie,49000000,31569268,105002056,56002056,114.28991020408164,-17430732,-35.5729224489796,tt1823672,2,IL,he
1212,13,"Nov 16, 2012",Anna Karenina,49000000,12816367,71004627,22004627,44.90740204081632,-36183633,-73.84414897959184,tt1781769,11,FI,sv
1212,13,"Nov 16, 2012",Anna Karenina,49000000,12816367,71004627,22004627,44.90740204081632,-36183633,-73.84414897959184,tt1781769,13,TR,tr
1214,15,"Oct 18, 2002",The Ring,48000000,129094024,248218486,200218486,417.12184583333334,81094024,168.94588333333334,tt5997666,5,IN,hi
1222,23,"Jan 22, 2010",Tooth Fairy,48000000,60022256,112610386,64610386,134.60497083333334,12022256,25.046366666666664,tt7906260,1,GB,en
1222,23,"Jan 22, 2010",Tooth Fairy,48000000,60022256,112610386,64610386,134.60497083333334,12022256,25.046366666666664,tt7906260,4,XWW,en
1228,29,"Jun 26, 1998",Out of Sight,48000000,37562568,77562568,29562568,61.588683333333336,-10437432,-21.74465,tt0959306,1,XWW,en
1233,34,"Nov 11, 2016",Arrival,47000000,100546139,203127894,156127894,332.1870085106383,53546139,113.92795531914895,tt2543164,23,CA,en
1235,36,"Apr 22, 2009",Earth,47000000,32011576,116773317,69773317,148.4538659574468,-14988424,-31.890263829787237,tt9746500,2,XWW,en
1239,40,"Jun 18, 2010",Jonah Hex,47000000,10547117,11022696,-35977304,-76.54745531914894,-36452883,-77.5593255319149,tt1075747,10,TR,tr
1239,40,"Jun 18, 2010",Jonah Hex,47000000,10547117,11022696,-35977304,-76.54745531914894,-36452883,-77.5593255319149,tt1075747,12,CA,fr
1241,42,"Dec 23, 2016",Silence,46500000,7100177,23726626,-22773374,-48.97499784946236,-39399823,-84.73080215053763,tt1731755,1,XWW,en
1241,42,"Dec 23, 2016",Silence,46500000,7100177,23726626,-22773374,-48.97499784946236,-39399823,-84.73080215053763,tt0490215,11,XWW,en
1241,42,"Dec 23, 2016",Silence,46500000,7100177,23726626,-22773374,-48.97499784946236,-39399823,-84.73080215053763,tt0490215,26,CA,fr
1257,58,"Dec 22, 2017",Pitch Perfect 3,45000000,104897530,185736412,140736412,312.7475822222222,59897530,133.10562222222222,tt4765284,13,IL,he
1262,63,"Jul 20, 1994",The Client,45000000,92115211,117615211,72615211,161.36713555555556,47115211,104.70046888888889,tt2072962,4,XWW,en
1289,90,"May 23, 2014",Blended,45000000,46290741,127990741,82990741,184.42386888888888,1290741,2.868313333333333,tt1086772,28,BE,fr
1302,3,"Nov 4, 1994",Frankenstein,45000000,22006296,112006296,67006296,148.90288,-22993704,-51.09712,tt1976009,10,XWW,en
1302,3,"Nov 4, 1994",Frankenstein,45000000,22006296,112006296,67006296,148.90288,-22993704,-51.09712,tt4086032,4,TR,tr
1305,6,"May 3, 2019",UglyDolls,45000000,19894664,24644664,-20355336,-45.23408,-25105336,-55.78963555555555,tt1946502,17,TR,tr
1306,7,"Jan 19, 2001",The Pledge,45000000,19719930,29406132,-15593868,-34.653040000000004,-25280070,-56.17793333333333,tt1878917,1,XWW,en
1306,7,"Jan 19, 2001",The Pledge,45000000,19719930,29406132,-15593868,-34.653040000000004,-25280070,-56.17793333333333,tt1878917,2,US,en
1314,15,"Sep 21, 2012",Dredd,45000000,13414714,41467606,-3532394,-7.849764444444444,-31585286,-70.18952444444444,tt1343727,23,CA,fr
1323,24,"Dec 25, 2002",Pinocchio,45000000,3681811,31681811,-13318189,-29.595975555555555,-41318189,-91.81819777777778,tt1693039,10,XWW,en
4867,68,"Feb 9, 1940",Pinocchio,2289247,84300000,84300000,82010753,3582.4335687673715,82010753,3582.4335687673715,tt1693039,10,XWW,en
1326,27,"Oct 12, 2012",Argo,44500000,136025503,227140757,182640757,410.42866741573033,91525503,205.67528764044943,tt1024648,17,BA,hr
1326,27,"Oct 12, 2012",Argo,44500000,136025503,227140757,182640757,410.42866741573033,91525503,205.67528764044943,tt1024648,1,CA,fr
1326,27,"Oct 12, 2012",Argo,44500000,136025503,227140757,182640757,410.42866741573033,91525503,205.67528764044943,tt1024648,7,IL,he
1331,32,"Feb 2, 1996",The Juror,44000000,22730924,22730924,-21269076,-48.33880909090909,-21269076,-48.33880909090909,tt6985094,3,XWW,en
1334,35,"Jun 28, 2013",The Heat,43000000,159581587,229727774,186727774,434.25063720930234,116581587,271.1199697674419,tt2404463,20,CA,en
1340,41,"Jan 6, 2017",A Monster Calls,43000000,3740823,46414530,3414530,7.940767441860465,-39259177,-91.30041162790697,tt3416532,12,XWW,en
1340,41,"Jan 6, 2017",A Monster Calls,43000000,3740823,46414530,3414530,7.940767441860465,-39259177,-91.30041162790697,tt3416532,21,GB,en
1343,44,"Mar 16, 2012",21 Jump Street,42000000,138447667,202812429,160812429,382.88673571428575,96447667,229.63730238095238,tt1232829,7,CA,fr
1347,48,"Jul 1, 1992",Boomerang,42000000,70052444,131052444,89052444,212.0296285714286,28052444,66.79153333333333,tt3582040,6,CA,fr
1357,58,"Dec 25, 2018",Holmes & Watson,42000000,30568743,41926605,-73395,-0.17475,-11431257,-27.217278571428572,tt1255919,11,IL,he
1370,71,"May 31, 2019",Rocketman,41000000,57342725,108642725,67642725,164.982256097561,16342725,39.86030487804878,tt2066051,10,IL,he
1382,83,"Jul 25, 2014",Lucy,40000000,126573960,457507776,417507776,1043.76944,86573960,216.4349,tt2872732,10,TR,tr
1382,83,"Jul 25, 2014",Lucy,40000000,126573960,457507776,417507776,1043.76944,86573960,216.4349,tt2872732,1,CA,fr
1382,83,"Jul 25, 2014",Lucy,40000000,126573960,457507776,417507776,1043.76944,86573960,216.4349,tt2872732,8,IL,he
1399,100,"Oct 14, 2016",The Accountant,40000000,86260045,152962083,112962083,282.4052075,46260045,115.65011249999999,tt2140479,14,CA,en
1405,6,"Sep 25, 2015",The Intern,40000000,75764672,197115710,157115710,392.789275,35764672,89.41168,tt1636456,4,XWW,en
1409,10,"Oct 16, 2015",Bridge of Spies,40000000,72313754,162498338,122498338,306.245845,32313754,80.784385,tt3682448,14,CA,en
1416,17,"Nov 4, 2016",Hacksaw Ridge,40000000,67209615,168904682,128904682,322.261705,27209615,68.0240375,tt2119532,26,CA,fr
1420,21,"Feb 18, 2011",Unknown,40000000,63686397,136123083,96123083,240.30770750000002,23686397,59.215992500000006,tt1401152,27,CA,en
4583,84,"Nov 3, 2006",Unknown,3700000,26403,3355048,-344952,-9.323027027027027,-3673597,-99.2864054054054,tt1401152,27,CA,en
1424,25,"Mar 18, 2011",The Lincoln Lawyer,40000000,58009200,87145086,47145086,117.86271500000001,18009200,45.023,tt1189340,6,HK,en
1426,27,"Aug 25, 2006",Invincible,40000000,57806952,58501127,18501127,46.2528175,17806952,44.51738,tt1809398,6,CA,fr
1434,35,"Jul 9, 2010",Predators,40000000,52000688,127234389,87234389,218.0859725,12000688,30.00172,tt1424381,21,JP,en
1434,35,"Jul 9, 2010",Predators,40000000,52000688,127234389,87234389,218.0859725,12000688,30.00172,tt1424381,8,TR,tr
1442,43,"Jun 20, 2014",Jersey Boys,40000000,47047013,65282732,25282732,63.206830000000004,7047013,17.6175325,tt1742044,12,CA,fr
1449,50,"Nov 16, 2018",Widows,40000000,42402632,73866088,33866088,84.66521999999999,2402632,6.0065800000000005,tt1785670,1,XWW,en
1453,54,"Jul 18, 2014",Sex Tape,40000000,38543473,126069509,86069509,215.17377249999998,-1456527,-3.6413175,tt1956620,4,IL,he
1457,58,"Mar 18, 2011",Paul,40000000,37412945,101162106,61162106,152.90526499999999,-2587055,-6.4676374999999995,tt1092026,11,IL,he
1457,58,"Mar 18, 2011",Paul,40000000,37412945,101162106,61162106,152.90526499999999,-2587055,-6.4676374999999995,tt1092026,19,CA,fr
1457,58,"Mar 18, 2011",Paul,40000000,37412945,101162106,61162106,152.90526499999999,-2587055,-6.4676374999999995,tt1092026,7,FI,sv
1457,58,"Mar 18, 2011",Paul,40000000,37412945,101162106,61162106,152.90526499999999,-2587055,-6.4676374999999995,tt1092026,8,TR,tr
1459,60,"Aug 26, 2011",Colombiana,40000000,36665854,72295262,32295262,80.738155,-3334146,-8.335365,tt1657507,14,IL,he
1466,67,"Apr 8, 2011",Arthur,40000000,33035397,47787943,7787943,19.4698575,-6964603,-17.4115075,tt1334512,4,CA,fr
1466,67,"Apr 8, 2011",Arthur,40000000,33035397,47787943,7787943,19.4698575,-6964603,-17.4115075,tt1334512,9,TR,tr
1468,69,"Dec 21, 2016",Patriots Day,40000000,31886361,52837989,12837989,32.094972500000004,-8113639,-20.2840975,tt4572514,15,JM,en
1470,71,"Jul 1, 1994",The Shadow,40000000,31835600,31835600,-8164400,-20.411,-8164400,-20.411,tt3406032,3,XWW,en
1470,71,"Jul 1, 1994",The Shadow,40000000,31835600,31835600,-8164400,-20.411,-8164400,-20.411,tt4581408,4,XWW,en
1474,75,"May 3, 2019",Long Shot,40000000,30202860,43711031,3711031,9.2775775,-9797140,-24.49285,tt2139881,6,XWW,en
1474,75,"May 3, 2019",Long Shot,40000000,30202860,43711031,3711031,9.2775775,-9797140,-24.49285,tt2139881,8,US,en
1476,77,"Dec 25, 2013",Grudge Match,40000000,29807260,69807260,29807260,74.51815,-10192740,-25.48185,tt1661382,33,CA,en
1483,84,"Jan 27, 2017",Resident Evil: The Final Chapter,40000000,26844692,314101190,274101190,685.252975,-13155308,-32.88827,tt2592614,17,CA,en
1485,86,"Jun 30, 2017",The House,40000000,25584504,31192425,-8807575,-22.0189375,-14415496,-36.038740000000004,tt1821406,4,XWW,en
1485,86,"Jun 30, 2017",The House,40000000,25584504,31192425,-8807575,-22.0189375,-14415496,-36.038740000000004,tt2408288,3,XWW,en
1485,86,"Jun 30, 2017",The House,40000000,25584504,31192425,-8807575,-22.0189375,-14415496,-36.038740000000004,tt3425402,6,XWW,en
1487,88,"Apr 5, 2007",The Reaping,40000000,25126214,62226214,22226214,55.565535,-14873786,-37.184465,tt4203258,2,XWW,en
1499,100,"Dec 21, 2012",The Impossible,40000000,19019882,169590606,129590606,323.976515,-20980118,-52.450295000000004,tt1649419,4,XWW,en
1514,15,"Mar 20, 2015",The Gunman,40000000,10664749,18594227,-21405773,-53.5144325,-29335251,-73.3381275,tt2515034,13,TR,tr
1520,21,"Jul 10, 2015",Baahubali: The Beginning,40000000,6738000,26736665,-13263335,-33.1583375,-33262000,-83.155,tt2631186,12,XWW,en
1520,21,"Jul 10, 2015",Baahubali: The Beginning,40000000,6738000,26736665,-13263335,-33.1583375,-33262000,-83.155,tt2631186,14,IN,ta
1523,24,"Nov 25, 2015",Victor Frankenstein,40000000,5775076,31124367,-8875633,-22.1890825,-34224924,-85.56231,tt1976009,15,TR,tr
1523,24,"Nov 25, 2015",Victor Frankenstein,40000000,5775076,31124367,-8875633,-22.1890825,-34224924,-85.56231,tt1976009,6,CA,fr
1526,27,"Jun 27, 2014",Snowpiercer,40000000,4563029,88069880,48069880,120.17469999999999,-35436971,-88.5924275,tt1706620,34,HK,en
1526,27,"Jun 27, 2014",Snowpiercer,40000000,4563029,88069880,48069880,120.17469999999999,-35436971,-88.5924275,tt1706620,7,XWW,en
1527,28,"Jul 20, 2007",Sunshine,40000000,3688560,32030610,-7969390,-19.923475,-36311440,-90.7786,tt6027448,1,XWW,en
1530,31,"Jul 1, 1986",Pirates,40000000,1641825,6341825,-33658175,-84.1454375,-38358175,-95.8954375,tt3485166,12,XWW,en
1536,37,"Mar 16, 2007",Nomad,40000000,79123,79123,-39920877,-99.8021925,-39920877,-99.8021925,tt6305342,1,XWW,en
1538,39,"Jun 21, 2019",Kursk,40000000,0,4212799,-35787201,-89.4680025,-40000000,-100.0,tt4951982,15,TR,tr
1547,48,"Oct 5, 2012",Frankenweenie,39000000,35287788,81150788,42150788,108.07894358974359,-3712212,-9.51849230769231,tt1142977,10,FI,sv
1547,48,"Oct 5, 2012",Frankenweenie,39000000,35287788,81150788,42150788,108.07894358974359,-3712212,-9.51849230769231,tt1142977,11,TR,tr
1547,48,"Oct 5, 2012",Frankenweenie,39000000,35287788,81150788,42150788,108.07894358974359,-3712212,-9.51849230769231,tt1142977,2,CA,fr
1547,48,"Oct 5, 2012",Frankenweenie,39000000,35287788,81150788,42150788,108.07894358974359,-3712212,-9.51849230769231,tt1142977,7,IL,he
1549,50,"Sep 30, 2005",Serenity,39000000,25514517,40319440,1319440,3.383179487179487,-13485483,-34.578161538461536,tt6476140,1,XWW,en
1549,50,"Sep 30, 2005",Serenity,39000000,25514517,40319440,1319440,3.383179487179487,-13485483,-34.578161538461536,tt6476140,7,US,en
2292,93,"Jan 25, 2019",Serenity,25000000,8547045,11367029,-13632971,-54.531884,-16452955,-65.81182,tt6476140,1,XWW,en
2292,93,"Jan 25, 2019",Serenity,25000000,8547045,11367029,-13632971,-54.531884,-16452955,-65.81182,tt6476140,7,US,en
1565,66,"Sep 6, 2013",Riddick,38000000,42025135,94763758,56763758,149.37831052631577,4025135,10.592460526315788,tt1411250,7,TR,tr
1568,69,"Jan 22, 2016",The 5th Wave,38000000,34912982,111336398,73336398,192.99052105263158,-3087018,-8.123731578947368,tt2304933,7,CA,en
1570,71,"Sep 20, 2013",Rush,38000000,26947624,98230839,60230839,158.50220789473684,-11052376,-29.0852,tt1979320,10,CA,fr
1581,82,"Sep 21, 2018",The Sisters Brothers,38000000,3143056,13143056,-24856944,-65.41301052631579,-34856944,-91.72879999999999,tt4971344,4,XWW,en
1586,87,"Sep 14, 2012",The Master,37500000,16247159,50647416,13147416,35.059776,-21252841,-56.674242666666665,tt1560747,24,TR,tr
1586,87,"Sep 14, 2012",The Master,37500000,16247159,50647416,13147416,35.059776,-21252841,-56.674242666666665,tt1560747,5,JP,en
1586,87,"Sep 14, 2012",The Master,37500000,16247159,50647416,13147416,35.059776,-21252841,-56.674242666666665,tt4851640,7,XWW,en
1590,91,"Nov 25, 2015",Creed,37000000,109767581,173567581,136567581,369.10157027027026,72767581,196.66913783783784,tt3076658,16,IL,he
1590,91,"Nov 25, 2015",Creed,37000000,109767581,173567581,136567581,369.10157027027026,72767581,196.66913783783784,tt3076658,29,CA,fr
1604,5,"Oct 5, 2018",A Star is Born,36000000,215288866,433449571,397449571,1104.026586111111,179288866,498.02462777777777,tt1776364,4,XWW,en
1619,20,"Jan 22, 2016",Yip Man 3,36000000,2679437,157300954,121300954,336.9470944444445,-33320563,-92.55711944444445,tt2888046,20,CA,fr
1622,23,"Mar 28, 2003",Head of State,35200000,37788228,38283765,3083765,8.760696022727272,2588228,7.352920454545455,tt5358844,2,XWW,en
1623,24,"Sep 8, 2017",It,35000000,327481748,697457969,662457969,1892.7370542857143,292481748,835.6621371428572,tt1396484,10,CA,en
1623,24,"Sep 8, 2017",It,35000000,327481748,697457969,662457969,1892.7370542857143,292481748,835.6621371428572,tt1396484,42,XWW,en
1623,24,"Sep 8, 2017",It,35000000,327481748,697457969,662457969,1892.7370542857143,292481748,835.6621371428572,tt1396484,8,US,en
1628,29,"Dec 22, 2010",True Grit,35000000,171243005,252276928,217276928,620.7912228571429,136243005,389.26572857142855,tt1403865,11,JP,en
1635,36,"Jul 17, 2015",Trainwreck,35000000,110212700,141123897,106123897,303.21113428571425,75212700,214.89342857142856,tt3152624,17,CA,en
1652,53,"Oct 8, 2010",Secretariat,35000000,59699513,60376247,25376247,72.50356285714285,24699513,70.57003714285715,tt1028576,12,CA,fr
1652,53,"Oct 8, 2010",Secretariat,35000000,59699513,60376247,25376247,72.50356285714285,24699513,70.57003714285715,tt1028576,20,IL,he
1661,62,"May 22, 2015",Poltergeist,35000000,47425125,95713069,60713069,173.46591142857142,12425125,35.50035714285714,tt1029360,12,CA,fr
1661,62,"May 22, 2015",Poltergeist,35000000,47425125,95713069,60713069,173.46591142857142,12425125,35.50035714285714,tt1029360,20,IL,he
3521,22,"Jun 4, 1982",Poltergeist,10700000,74706019,121706019,111006019,1037.439429906542,64006019,598.1870934579439,tt1029360,12,CA,fr
3521,22,"Jun 4, 1982",Poltergeist,10700000,74706019,121706019,111006019,1037.439429906542,64006019,598.1870934579439,tt1029360,20,IL,he
1662,63,"Oct 12, 2018",Goosebumps 2: Haunted Halloween,35000000,46697321,93291478,58291478,166.54708,11697321,33.42091714285714,tt5664636,9,HK,en
1673,74,"Oct 28, 2011",In Time,35000000,37553932,165103952,130103952,371.72557714285716,2553932,7.296948571428572,tt1637688,16,NZ,en
1673,74,"Oct 28, 2011",In Time,35000000,37553932,165103952,130103952,371.72557714285716,2553932,7.296948571428572,tt1637688,27,CA,en
1673,74,"Oct 28, 2011",In Time,35000000,37553932,165103952,130103952,371.72557714285716,2553932,7.296948571428572,tt1637688,30,IE,en
1675,76,"Nov 9, 2011",J. Edgar,35000000,37306030,84606030,49606030,141.7315142857143,2306030,6.588657142857143,tt1616195,14,IL,en
1675,76,"Nov 9, 2011",J. Edgar,35000000,37306030,84606030,49606030,141.7315142857143,2306030,6.588657142857143,tt1616195,1,TR,tr
1675,76,"Nov 9, 2011",J. Edgar,35000000,37306030,84606030,49606030,141.7315142857143,2306030,6.588657142857143,tt1616195,7,CA,fr
1677,78,"Aug 17, 2018",Mile 22,35000000,36108758,66295121,31295121,89.41463142857144,1108758,3.16788,tt4560436,11,IL,he
1677,78,"Aug 17, 2018",Mile 22,35000000,36108758,66295121,31295121,89.41463142857144,1108758,3.16788,tt4560436,13,TR,tr
1688,89,"Jun 1, 2018",Adrift,35000000,31445011,57897191,22897191,65.42054571428572,-3554989,-10.15711142857143,tt2408090,1,XWW,en
1690,91,"Jan 6, 2017",Underworld: Blood Wars,35000000,30353973,81209222,46209222,132.02634857142857,-4646027,-13.274362857142858,tt3717252,19,CA,en
1690,91,"Jan 6, 2017",Underworld: Blood Wars,35000000,30353973,81209222,46209222,132.02634857142857,-4646027,-13.274362857142858,tt3717252,20,US,en
1690,91,"Jan 6, 2017",Underworld: Blood Wars,35000000,30353973,81209222,46209222,132.02634857142857,-4646027,-13.274362857142858,tt3717252,30,XWW,en
1695,96,"Sep 23, 2011",Abduction,35000000,28087155,86648359,51648359,147.56674,-6912845,-19.750985714285715,tt1604670,1,XWW,en
1695,96,"Sep 23, 2011",Abduction,35000000,28087155,86648359,51648359,147.56674,-6912845,-19.750985714285715,tt4610748,10,CA,en
1695,96,"Sep 23, 2011",Abduction,35000000,28087155,86648359,51648359,147.56674,-6912845,-19.750985714285715,tt4610748,3,XWW,en
1699,100,"Oct 19, 2012",Alex Cross,35000000,25888412,35426759,426759,1.2193114285714286,-9111588,-26.03310857142857,tt1712170,11,CA,fr
1699,100,"Oct 19, 2012",Alex Cross,35000000,25888412,35426759,426759,1.2193114285714286,-9111588,-26.03310857142857,tt1712170,18,IL,he
1699,100,"Oct 19, 2012",Alex Cross,35000000,25888412,35426759,426759,1.2193114285714286,-9111588,-26.03310857142857,tt1712170,7,TR,tr
1705,6,"Mar 4, 2016",Whiskey Tango Foxtrot,35000000,23083334,25350747,-9649253,-27.569294285714285,-11916666,-34.04761714285714,tt3553442,5,CA,fr
1707,8,"Aug 21, 2015",Hitman: Agent 47,35000000,22467450,82182803,47182803,134.80800857142856,-12532550,-35.80728571428571,tt2679042,22,XWW,en
1707,8,"Aug 21, 2015",Hitman: Agent 47,35000000,22467450,82182803,47182803,134.80800857142856,-12532550,-35.80728571428571,tt2679042,9,CA,en
1713,14,"Feb 25, 2005",Cursed,35000000,19294901,25114901,-9885099,-28.24314,-15705099,-44.87171142857142,tt3705608,3,XWW,en
1713,14,"Feb 25, 2005",Cursed,35000000,19294901,25114901,-9885099,-28.24314,-15705099,-44.87171142857142,tt6396104,5,XWW,en
1713,14,"Feb 25, 2005",Cursed,35000000,19294901,25114901,-9885099,-28.24314,-15705099,-44.87171142857142,tt9110566,4,XWW,en
1717,18,"Jan 25, 2013",Parker,35000000,17616641,48543388,13543388,38.695394285714286,-17383359,-49.66674,tt1904996,10,TR,tr
1717,18,"Jan 25, 2013",Parker,35000000,17616641,48543388,13543388,38.695394285714286,-17383359,-49.66674,tt1904996,11,CA,fr
1717,18,"Jan 25, 2013",Parker,35000000,17616641,48543388,13543388,38.695394285714286,-17383359,-49.66674,tt1904996,19,IL,he
1717,18,"Jan 25, 2013",Parker,35000000,17616641,48543388,13543388,38.695394285714286,-17383359,-49.66674,tt1904996,9,FI,sv
1723,24,"May 27, 2011",The Tree of Life,35000000,13305665,61721826,26721826,76.34807428571429,-21694335,-61.98381428571429,tt2746284,3,XWW,en
1725,26,"Aug 11, 2006",Zoom,35000000,11989328,12506188,-22493812,-64.26803428571428,-23010672,-65.74477714285715,tt3763866,3,CA,fr
1728,29,"Mar 28, 2014",Sabotage,35000000,10508518,18376443,-16623557,-47.49587714285714,-24491482,-69.97566285714286,tt1742334,18,CA,fr
1728,29,"Mar 28, 2014",Sabotage,35000000,10508518,18376443,-16623557,-47.49587714285714,-24491482,-69.97566285714286,tt1742334,27,LU,fr
1728,29,"Mar 28, 2014",Sabotage,35000000,10508518,18376443,-16623557,-47.49587714285714,-24491482,-69.97566285714286,tt1742334,6,CA,en
1734,35,"Nov 29, 2013",Mandela: Long Walk to Freedom,35000000,8323085,29890402,-5109598,-14.59885142857143,-26676915,-76.21975714285715,tt2304771,16,CA,en
1734,35,"Nov 29, 2013",Mandela: Long Walk to Freedom,35000000,8323085,29890402,-5109598,-14.59885142857143,-26676915,-76.21975714285715,tt2304771,7,LU,fr
1743,44,"Jan 28, 2011",Biutiful,35000000,5101237,24687524,-10312476,-29.46421714285714,-29898763,-85.42503714285714,tt1164999,10,IL,he
1743,44,"Jan 28, 2011",Biutiful,35000000,5101237,24687524,-10312476,-29.46421714285714,-29898763,-85.42503714285714,tt1164999,12,CA,fr
1743,44,"Jan 28, 2011",Biutiful,35000000,5101237,24687524,-10312476,-29.46421714285714,-29898763,-85.42503714285714,tt1164999,5,TR,tr
1758,59,"Jun 28, 2017",Baby Driver,34000000,107825862,228104185,194104185,570.8946617647059,73825862,217.1348882352941,tt3890160,10,IE,en
1758,59,"Jun 28, 2017",Baby Driver,34000000,107825862,228104185,194104185,570.8946617647059,73825862,217.1348882352941,tt3890160,1,CA,en
1758,59,"Jun 28, 2017",Baby Driver,34000000,107825862,228104185,194104185,570.8946617647059,73825862,217.1348882352941,tt3890160,25,IL,he
1759,60,"Sep 19, 2014",The Maze Runner,34000000,102427862,348319861,314319861,924.4701794117648,68427862,201.25841764705882,tt1790864,10,CA,en
1761,62,"Sep 17, 1993",The Age of Innocence,34000000,32014993,32014993,-1985007,-5.838255882352941,-1985007,-5.838255882352941,tt5004902,1,XWW,en
1772,73,"Jul 8, 2016",Mike and Dave Need Wedding Dates,33000000,46009673,75898100,42898100,129.99424242424243,13009673,39.42325151515151,tt2823054,21,NZ,en
1772,73,"Jul 8, 2016",Mike and Dave Need Wedding Dates,33000000,46009673,75898100,42898100,129.99424242424243,13009673,39.42325151515151,tt2823054,32,IE,en
1772,73,"Jul 8, 2016",Mike and Dave Need Wedding Dates,33000000,46009673,75898100,42898100,129.99424242424243,13009673,39.42325151515151,tt2823054,33,CA,en
1777,78,"Apr 27, 2012",Safe,33000000,17142080,41495213,8495213,25.743069696969695,-15857920,-48.05430303030303,tt1656190,25,CA,en
1778,79,"Mar 14, 2008",Doomsday,33000000,11008770,21621188,-11378812,-34.481248484848486,-21991230,-66.64009090909092,tt2805976,1,XWW,en
1781,82,"Jul 31, 2015",The Young and Prodigious T.S. Spivet,33000000,176847,357687,-32642313,-98.9161,-32823153,-99.4641,tt1981107,13,XWW,en
1782,83,"Oct 30, 2015",Freaks of Nature,33000000,70958,70958,-32929042,-99.78497575757575,-32929042,-99.78497575757575,tt1817771,11,CA,en
1782,83,"Oct 30, 2015",Freaks of Nature,33000000,70958,70958,-32929042,-99.78497575757575,-32929042,-99.78497575757575,tt1817771,12,CA,fr
1784,85,"May 13, 2011",Bridesmaids,32500000,169211718,289632023,257132023,791.1754553846154,136711718,420.65144,tt1478338,15,CA,en
1786,87,"Apr 26, 2013",The Big Wedding,32500000,21819348,48425971,15925971,49.00298769230769,-10680652,-32.86354461538462,tt2006721,2,CA,en
1787,88,"Feb 24, 2012",Wanderlust,32500000,17288155,24159934,-8340066,-25.66174153846154,-15211845,-46.80567692307692,tt1655460,8,CA,fr
1789,90,"Jul 5, 1996",Phenomenon,32000000,104636382,152036382,120036382,375.11369375000004,72636382,226.98869374999998,tt6209808,1,XWW,en
1801,2,"Jan 15, 1993",Alive,32000000,36299670,36299670,4299670,13.43646875,4299670,13.43646875,tt3797214,3,XWW,en
1810,11,"Sep 3, 2010",Going the Distance,32000000,17804299,43603990,11603990,36.26246875,-14195701,-44.361565625,tt6135412,3,XWW,en
1820,21,"Apr 15, 2016",Criminal,31500000,14708696,38771262,7271262,23.08337142857143,-16791304,-53.30572698412699,tt3014866,15,IL,he
1822,23,"Nov 2, 2012",Flight,31000000,93772375,160558438,129558438,417.9304451612904,62772375,202.49153225806452,tt1639426,5,XWW,en
1826,27,"Mar 7, 2014",The Grand Budapest Hotel,31000000,59076019,163981261,132981261,428.97180967741934,28076019,90.56780322580646,tt2278388,26,CH,fr
1826,27,"Mar 7, 2014",The Grand Budapest Hotel,31000000,59076019,163981261,132981261,428.97180967741934,28076019,90.56780322580646,tt2278388,27,CH,de
1826,27,"Mar 7, 2014",The Grand Budapest Hotel,31000000,59076019,163981261,132981261,428.97180967741934,28076019,90.56780322580646,tt2278388,5,CH,it
1830,31,"Apr 28, 2000",Frequency,31000000,44983704,68079671,37079671,119.61184193548387,13983704,45.108722580645164,tt2353965,2,US,en
1830,31,"Apr 28, 2000",Frequency,31000000,44983704,68079671,37079671,119.61184193548387,13983704,45.108722580645164,tt2353965,3,XWW,en
1837,38,"Aug 15, 2018",Crazy Rich Asians,30000000,174532921,238099711,208099711,693.6657033333333,144532921,481.7764033333333,tt3104988,4,EG,en
1844,45,"Aug 16, 2013",Lee Daniels' The Butler,30000000,116632095,177025498,147025498,490.08499333333333,86632095,288.77365,tt1327773,32,US,en
1860,61,"Jun 25, 2004",The Notebook,30000000,81001787,116025023,86025023,286.7500766666667,51001787,170.00595666666666,tt2324384,19,XWW,en
1868,69,"Sep 28, 2012",Looper,30000000,66486205,170466405,140466405,468.22135,36486205,121.62068333333333,tt1276104,17,IL,he
1880,81,"Jan 9, 2009",Bride Wars,30000000,58715510,115150424,85150424,283.83474666666666,28715510,95.71836666666667,tt3833460,1,XWW,en
1899,100,"Sep 18, 2015",Sicario,30000000,46889293,84393749,54393749,181.31249666666668,16889293,56.29764333333333,tt3397884,15,CA,en
1899,100,"Sep 18, 2015",Sicario,30000000,46889293,84393749,54393749,181.31249666666668,16889293,56.29764333333333,tt3397884,17,IE,en
1899,100,"Sep 18, 2015",Sicario,30000000,46889293,84393749,54393749,181.31249666666668,16889293,56.29764333333333,tt3397884,2,IL,he
1899,100,"Sep 18, 2015",Sicario,30000000,46889293,84393749,54393749,181.31249666666668,16889293,56.29764333333333,tt3397884,34,CA,fr
1899,100,"Sep 18, 2015",Sicario,30000000,46889293,84393749,54393749,181.31249666666668,16889293,56.29764333333333,tt3397884,7,TR,tr
1905,6,"Oct 24, 2014",John Wick,30000000,43037835,76235001,46235001,154.11667,13037835,43.45945,tt2911666,10,IL,he
1905,6,"Oct 24, 2014",John Wick,30000000,43037835,76235001,46235001,154.11667,13037835,43.45945,tt2911666,12,TR,tr
1905,6,"Oct 24, 2014",John Wick,30000000,43037835,76235001,46235001,154.11667,13037835,43.45945,tt2911666,1,CA,fr
1910,11,"Apr 13, 2012",The Cabin in the Woods,30000000,42073277,70689968,40689968,135.63322666666667,12073277,40.244256666666665,tt1259521,11,US,en
1910,11,"Apr 13, 2012",The Cabin in the Woods,30000000,42073277,70689968,40689968,135.63322666666667,12073277,40.244256666666665,tt1259521,8,XWW,en
1913,14,"Apr 8, 2011",Hanna,30000000,40259119,65343694,35343694,117.81231333333334,10259119,34.19706333333333,tt0993842,13,CA,fr
1913,14,"Apr 8, 2011",Hanna,30000000,40259119,65343694,35343694,117.81231333333334,10259119,34.19706333333333,tt0993842,17,TR,tr
1913,14,"Apr 8, 2011",Hanna,30000000,40259119,65343694,35343694,117.81231333333334,10259119,34.19706333333333,tt0993842,22,IL,he
1918,19,"Jul 20, 1988",Midnight Run,30000000,38413606,81613606,51613606,172.04535333333334,8413606,28.045353333333335,tt5735262,1,XWW,en
1921,22,"Sep 13, 2013",The Family,30000000,36918811,51078541,21078541,70.26180333333333,6918811,23.062703333333335,tt5161028,3,XWW,en
1921,22,"Sep 13, 2013",The Family,30000000,36918811,51078541,21078541,70.26180333333333,6918811,23.062703333333335,tt6107516,4,XWW,en
1921,22,"Sep 13, 2013",The Family,30000000,36918811,51078541,21078541,70.26180333333333,6918811,23.062703333333335,tt5029482,3,AU,en
1921,22,"Sep 13, 2013",The Family,30000000,36918811,51078541,21078541,70.26180333333333,6918811,23.062703333333335,tt5029482,5,XWW,en
1924,25,"Jul 1, 2011",Larry Crowne,30000000,35608245,61449135,31449135,104.83045,5608245,18.69415,tt1583420,19,TR,tr
1924,25,"Jul 1, 2011",Larry Crowne,30000000,35608245,61449135,31449135,104.83045,5608245,18.69415,tt1583420,21,IL,he
1924,25,"Jul 1, 2011",Larry Crowne,30000000,35608245,61449135,31449135,104.83045,5608245,18.69415,tt1583420,22,CA,fr
1925,26,"Oct 18, 2013",Carrie,30000000,35266619,82409520,52409520,174.69840000000002,5266619,17.555396666666667,tt1939659,21,BA,hr
1925,26,"Oct 18, 2013",Carrie,30000000,35266619,82409520,52409520,174.69840000000002,5266619,17.555396666666667,tt1939659,9,CA,fr
5015,16,"Nov 16, 1976",Carrie,1800000,25878153,25878153,24078153,1337.6751666666667,24078153,1337.6751666666667,tt1939659,21,BA,hr
5015,16,"Nov 16, 1976",Carrie,1800000,25878153,25878153,24078153,1337.6751666666667,24078153,1337.6751666666667,tt1939659,9,CA,fr
1929,30,"Jun 3, 2015",Entourage,30000000,32363404,46438538,16438538,54.79512666666667,2363404,7.8780133333333335,tt1674771,10,CA,fr
1929,30,"Jun 3, 2015",Entourage,30000000,32363404,46438538,16438538,54.79512666666667,2363404,7.8780133333333335,tt1674771,14,TR,tr
1932,33,"Sep 9, 2009",9,30000000,31749894,48559999,18559999,61.866663333333335,1749894,5.83298,tt8180482,5,XWW,en
1938,39,"Jul 15, 2011",Winnie the Pooh,30000000,26692846,50145607,20145607,67.15202333333333,-3307154,-11.023846666666667,tt1449283,7,TR,tr
1938,39,"Jul 15, 2011",Winnie the Pooh,30000000,26692846,50145607,20145607,67.15202333333333,-3307154,-11.023846666666667,tt4575576,7,US,en
1944,45,"Feb 4, 2011",Sanctum,30000000,23209310,108957098,78957098,263.1903266666667,-6790690,-22.63563333333333,tt0881320,11,JP,en
1944,45,"Feb 4, 2011",Sanctum,30000000,23209310,108957098,78957098,263.1903266666667,-6790690,-22.63563333333333,tt0881320,14,TR,tr
1944,45,"Feb 4, 2011",Sanctum,30000000,23209310,108957098,78957098,263.1903266666667,-6790690,-22.63563333333333,tt0881320,19,IL,he
1944,45,"Feb 4, 2011",Sanctum,30000000,23209310,108957098,78957098,263.1903266666667,-6790690,-22.63563333333333,tt0881320,20,CA,fr
1946,47,"Aug 25, 2017",Ballerina,30000000,21858070,96892829,66892829,222.97609666666665,-8141930,-27.139766666666667,tt2261287,29,XWW,en
1946,47,"Aug 25, 2017",Ballerina,30000000,21858070,96892829,66892829,222.97609666666665,-8141930,-27.139766666666667,tt2261287,39,CA,fr
1959,60,"Oct 9, 2015",Steve Jobs,30000000,17766658,35579007,5579007,18.59669,-12233342,-40.77780666666666,tt2080374,18,IL,he
1959,60,"Oct 9, 2015",Steve Jobs,30000000,17766658,35579007,5579007,18.59669,-12233342,-40.77780666666666,tt2080374,9,TR,tr
1959,60,"Oct 9, 2015",Steve Jobs,30000000,17766658,35579007,5579007,18.59669,-12233342,-40.77780666666666,tt2357129,21,JP,en
1968,69,"Apr 30, 2004",Godsend,30000000,14334645,16910708,-13089292,-43.63097333333334,-15665355,-52.21785,tt2492700,3,XWW,en
1971,72,"Dec 25, 2005",The New World,30000000,12712093,26184400,-3815600,-12.718666666666667,-17287907,-57.626356666666666,tt2080410,1,XWW,en
1971,72,"Dec 25, 2005",The New World,30000000,12712093,26184400,-3815600,-12.718666666666667,-17287907,-57.626356666666666,tt2625030,7,XWW,en
1971,72,"Dec 25, 2005",The New World,30000000,12712093,26184400,-3815600,-12.718666666666667,-17287907,-57.626356666666666,tt4354276,2,XWW,en
1981,82,"Apr 14, 2017",The Lost City of Z,30000000,8574339,17121823,-12878177,-42.92725666666667,-21425661,-71.41887,tt1212428,7,CA,en
1986,87,"Sep 20, 2002",Trapped,30000000,6916869,6916869,-23083131,-76.94377,-23083131,-76.94377,tt3269074,1,XWW,en
1986,87,"Sep 20, 2002",Trapped,30000000,6916869,6916869,-23083131,-76.94377,-23083131,-76.94377,tt4960576,4,IN,en
1987,88,"Aug 31, 2018",Kin,30000000,5718096,10096821,-19903179,-66.34393,-24281904,-80.93968000000001,tt1667310,8,XWW,en
1990,91,"Jan 22, 1999",Gloria,30000000,4167493,4967493,-25032507,-83.44169000000001,-25832507,-86.10835666666667,tt2425486,6,TR,tr
1990,91,"Jan 22, 1999",Gloria,30000000,4167493,4967493,-25032507,-83.44169000000001,-25832507,-86.10835666666667,tt2425486,8,FI,sv
2010,11,"Dec 31, 2013",Space Pirate Captain Harlock,30000000,0,310985,-29689015,-98.96338333333333,-30000000,-100.0,tt2668134,3,JP,en
2020,21,"Aug 18, 2017",Logan Lucky,29000000,27778642,44264271,15264271,52.635417241379315,-1221358,-4.211579310344828,tt5439796,11,IL,he
2021,22,"Aug 12, 2016",Florence Foster Jenkins,29000000,27383770,56000339,27000339,93.1046172413793,-1616230,-5.573206896551723,tt4136084,10,CA,fr
2021,22,"Aug 12, 2016",Florence Foster Jenkins,29000000,27383770,56000339,27000339,93.1046172413793,-1616230,-5.573206896551723,tt4136084,11,IL,he
2021,22,"Aug 12, 2016",Florence Foster Jenkins,29000000,27383770,56000339,27000339,93.1046172413793,-1616230,-5.573206896551723,tt4136084,18,CA,en
2021,22,"Aug 12, 2016",Florence Foster Jenkins,29000000,27383770,56000339,27000339,93.1046172413793,-1616230,-5.573206896551723,tt4136084,23,FI,sv
2044,45,"Feb 6, 2004",Miracle,28000000,64378093,64474705,36474705,130.26680357142857,36378093,129.9217607142857,tt3012818,2,XEU,en
2044,45,"Feb 6, 2004",Miracle,28000000,64378093,64474705,36474705,130.26680357142857,36378093,129.9217607142857,tt3012818,3,XWW,en
2044,45,"Feb 6, 2004",Miracle,28000000,64378093,64474705,36474705,130.26680357142857,36378093,129.9217607142857,tt3045930,3,XWW,en
2044,45,"Feb 6, 2004",Miracle,28000000,64378093,64474705,36474705,130.26680357142857,36378093,129.9217607142857,tt6682904,1,XWW,en
2045,46,"Jan 28, 2013",Last Vegas,28000000,63914167,112914167,84914167,303.2648821428571,35914167,128.26488214285715,tt1204975,13,TR,tr
2049,50,"Jun 15, 2018",Tag,28000000,54730625,77026186,49026186,175.09352142857142,26730625,95.46651785714285,tt2854926,19,CA,fr
2049,50,"Jun 15, 2018",Tag,28000000,54730625,77026186,49026186,175.09352142857142,26730625,95.46651785714285,tt4439120,11,XWW,en
2053,54,"Apr 16, 2010",Kick-Ass,28000000,48071303,97531134,69531134,248.32547857142856,20071303,71.683225,tt1250777,8,CA,fr
2089,90,"Oct 28, 2011",Anonymous,27500000,4463292,15815509,-11684491,-42.48905818181819,-23036708,-83.76984727272728,tt3173594,5,XWW,en
2113,14,"Nov 24, 1999",Flawless,27000000,4485485,4485485,-22514515,-83.3870925925926,-22514515,-83.3870925925926,tt8653840,2,XWW,en
2136,37,"Jan 22, 2010",Legion,26000000,40168080,67647574,41647574,160.18297692307692,14168080,54.492615384615384,tt1038686,12,IR,fa
2137,38,"Aug 29, 2012",Lawless,26000000,37397291,54393687,28393687,109.20648846153847,11397291,43.83573461538462,tt4053684,1,XEU,en
2140,41,"Dec 4, 2009",Brothers,26000000,28544157,45043870,19043870,73.24565384615384,2544157,9.785219230769231,tt1754838,3,XWW,en
2140,41,"Dec 4, 2009",Brothers,26000000,28544157,45043870,19043870,73.24565384615384,2544157,9.785219230769231,tt2246837,1,IN,te
2140,41,"Dec 4, 2009",Brothers,26000000,28544157,45043870,19043870,73.24565384615384,2544157,9.785219230769231,tt4952376,1,XWW,en
2140,41,"Dec 4, 2009",Brothers,26000000,28544157,45043870,19043870,73.24565384615384,2544157,9.785219230769231,tt3650484,4,XWW,en
2140,41,"Dec 4, 2009",Brothers,26000000,28544157,45043870,19043870,73.24565384615384,2544157,9.785219230769231,tt6314294,1,XWW,en
2140,41,"Dec 4, 2009",Brothers,26000000,28544157,45043870,19043870,73.24565384615384,2544157,9.785219230769231,tt8655740,1,XWW,en
3307,8,"Aug 14, 2015",Brothers,13000000,656688,17856688,4856688,37.35913846153846,-12343312,-94.94855384615384,tt1754838,3,XWW,en
3307,8,"Aug 14, 2015",Brothers,13000000,656688,17856688,4856688,37.35913846153846,-12343312,-94.94855384615384,tt2246837,1,IN,te
3307,8,"Aug 14, 2015",Brothers,13000000,656688,17856688,4856688,37.35913846153846,-12343312,-94.94855384615384,tt4952376,1,XWW,en
3307,8,"Aug 14, 2015",Brothers,13000000,656688,17856688,4856688,37.35913846153846,-12343312,-94.94855384615384,tt3650484,4,XWW,en
3307,8,"Aug 14, 2015",Brothers,13000000,656688,17856688,4856688,37.35913846153846,-12343312,-94.94855384615384,tt6314294,1,XWW,en
3307,8,"Aug 14, 2015",Brothers,13000000,656688,17856688,4856688,37.35913846153846,-12343312,-94.94855384615384,tt8655740,1,XWW,en
2144,45,"Apr 27, 2012",The Raven,26000000,16008272,30601801,4601801,17.699234615384615,-9991728,-38.429723076923075,tt1486192,10,CA,en
2151,52,"Mar 21, 2014",Blood Ties,26000000,42472,2923959,-23076041,-88.75400384615385,-25957528,-99.83664615384615,tt1747958,17,CA,en
2151,52,"Mar 21, 2014",Blood Ties,26000000,42472,2923959,-23076041,-88.75400384615385,-25957528,-99.83664615384615,tt1679620,3,XWW,en
2151,52,"Mar 21, 2014",Blood Ties,26000000,42472,2923959,-23076041,-88.75400384615385,-25957528,-99.83664615384615,tt2941230,4,XWW,en
2163,64,"Dec 25, 2016",Hidden Figures,25000000,169607287,231771716,206771716,827.086864,144607287,578.429148,tt4846340,15,CA,en
2166,67,"Jan 17, 2014",Ride Along,25000000,134202565,153733800,128733800,514.9352,109202565,436.81026,tt1408253,20,CA,en
2167,68,"Nov 25, 1992",The Bodyguard,25000000,121945720,410899039,385899039,1543.596156,96945720,387.78288000000003,tt1821478,1,XWW,en
2167,68,"Nov 25, 1992",The Bodyguard,25000000,121945720,410899039,385899039,1543.596156,96945720,387.78288000000003,tt1821478,3,IN,en
2167,68,"Nov 25, 1992",The Bodyguard,25000000,121945720,410899039,385899039,1543.596156,96945720,387.78288000000003,tt4970038,6,IN,en
2182,83,"Dec 15, 2000",Chocolat,25000000,71309760,152500343,127500343,510.00137199999995,46309760,185.23904,tt4400038,24,CA,fr
2192,93,"Dec 13, 2013",Tyler Perry's A Madea Christmas,25000000,52543354,52543354,27543354,110.17341599999999,27543354,110.17341599999999,tt2609758,3,US,en
2195,96,"Jan 28, 2005",Hide and Seek,25000000,51100486,123696741,98696741,394.786964,26100486,104.401944,tt3155654,3,XWW,en
2195,96,"Jan 28, 2005",Hide and Seek,25000000,51100486,123696741,98696741,394.786964,26100486,104.401944,tt5457656,3,XWW,en
2195,96,"Jan 28, 2005",Hide and Seek,25000000,51100486,123696741,98696741,394.786964,26100486,104.401944,tt7699008,3,XWW,en
2195,96,"Jan 28, 2005",Hide and Seek,25000000,51100486,123696741,98696741,394.786964,26100486,104.401944,tt9049340,3,IN,en
2195,96,"Jan 28, 2005",Hide and Seek,25000000,51100486,123696741,98696741,394.786964,26100486,104.401944,tt5662906,1,XWW,en
2195,96,"Jan 28, 2005",Hide and Seek,25000000,51100486,123696741,98696741,394.786964,26100486,104.401944,tt5662906,3,CN,cmn
2224,25,"Dec 10, 2014",The Gambler,25000000,33680992,38718031,13718031,54.872124,8680992,34.723968,tt2924336,4,XWW,en
4749,50,"Aug 4, 1999",The Gambler,3000000,51773,101773,-2898227,-96.60756666666667,-2948227,-98.27423333333334,tt2924336,4,XWW,en
2245,46,"Aug 24, 2007",War,25000000,22486409,40686409,15686409,62.745636000000005,-2513591,-10.054364,tt4105466,7,XWW,en
2249,50,"Feb 11, 2011",The Eagle,25000000,19490041,38993548,13993548,55.974192,-5509959,-22.039835999999998,tt1034389,1,CA,en
2249,50,"Feb 11, 2011",The Eagle,25000000,19490041,38993548,13993548,55.974192,-5509959,-22.039835999999998,tt1083452,13,XWW,en
2265,66,"Nov 6, 2009",The Box,25000000,15051977,34356760,9356760,37.42704,-9948023,-39.792092000000004,tt1728200,3,XWW,en
2267,68,"Oct 8, 2010",My Soul to Take,25000000,14744435,16727470,-8272530,-33.09012,-10255565,-41.02226,tt0872230,4,XWW,en
2275,76,"Sep 22, 2017",Battle of the Sexes,25000000,12638526,18445379,-6554621,-26.218483999999997,-12361474,-49.445896,tt2386868,6,XWW,en
2289,90,"Aug 16, 2002",Possession,25000000,10103647,14805812,-10194188,-40.776752,-14896353,-59.585412000000005,tt0431021,17,CA,fr
2289,90,"Aug 16, 2002",Possession,25000000,10103647,14805812,-10194188,-40.776752,-14896353,-59.585412000000005,tt2974248,3,XWW,en
2293,94,"Nov 25, 2009",The Road,25000000,8114270,29206732,4206732,16.826928,-16885730,-67.54292,tt1794774,1,XWW,en
2293,94,"Nov 25, 2009",The Road,25000000,8114270,29206732,4206732,16.826928,-16885730,-67.54292,tt2346048,2,XWW,en
2294,95,"Oct 12, 2018",Beautiful Boy,25000000,7634767,13031424,-11968576,-47.874304,-17365233,-69.460932,tt1226837,6,JP,en
2296,97,"Mar 15, 2019",Captive State,25000000,5958315,8993300,-16006700,-64.0268,-19041685,-76.16674,tt5968394,10,US,en
2296,97,"Mar 15, 2019",Captive State,25000000,5958315,8993300,-16006700,-64.0268,-19041685,-76.16674,tt5968394,21,XWW,en
2301,2,"Apr 25, 2008",Deception,25000000,4598506,12850033,-12149967,-48.599868,-20401494,-81.605976,tt3565264,4,XWW,en
2304,5,"Oct 3, 2008",Blindness,25000000,3073392,20052958,-4947042,-19.788168,-21926608,-87.706432,tt5662990,1,XWW,en
2306,7,"Dec 16, 2011",Carnage,25000000,2546747,38112154,13112154,52.448616,-22453253,-89.813012,tt1692486,29,CA,fr
2306,7,"Dec 16, 2011",Carnage,25000000,2546747,38112154,13112154,52.448616,-22453253,-89.813012,tt6667360,2,XWW,en
2306,7,"Dec 16, 2011",Carnage,25000000,2546747,38112154,13112154,52.448616,-22453253,-89.813012,tt6667360,6,GB,en
2320,21,"Dec 31, 2010",Sammy's avonturen: De geheime doorgang,25000000,0,71594792,46594792,186.379168,-25000000,-100.0,tt1230204,2,BE,nl
2324,25,"Jul 8, 2011",Ironclad,25000000,0,5297411,-19702589,-78.810356,-25000000,-100.0,tt1233301,19,CA,en
2325,26,"May 10, 2019",The Professor and the Madman,25000000,0,5227233,-19772767,-79.09106799999999,-25000000,-100.0,tt5932728,18,XWW,en
2325,26,"May 10, 2019",The Professor and the Madman,25000000,0,5227233,-19772767,-79.09106799999999,-25000000,-100.0,tt5932728,20,IE,en
2326,27,"Mar 10, 2015",Red Sky,25000000,0,91116,-24908884,-99.635536,-25000000,-100.0,tt1836838,3,XWW,en
2326,27,"Mar 10, 2015",Red Sky,25000000,0,91116,-24908884,-99.635536,-25000000,-100.0,tt6950432,4,XWW,en
2330,31,"Nov 9, 2012",Dangerous Liaisons,24200000,17000,10447579,-13752421,-56.82818595041322,-24183000,-99.92975206611571,tt2071441,10,XWW,en
3187,88,"Dec 21, 1988",Dangerous Liaisons,14000000,34700000,34700000,20700000,147.85714285714286,20700000,147.85714285714286,tt2071441,10,XWW,en
2338,39,"Oct 14, 2011",Footloose,24000000,51802742,62989834,38989834,162.4576416666667,27802742,115.84475833333335,tt1068242,8,CA,fr
3860,61,"Feb 17, 1984",Footloose,8200000,80000000,80000000,71800000,875.609756097561,71800000,875.609756097561,tt1068242,8,CA,fr
2360,61,"Dec 17, 2004",Beyond the Sea,24000000,6144806,8292914,-15707086,-65.44619166666666,-17855194,-74.39664166666667,tt2757252,2,XWW,en
2365,66,"Dec 31, 2007",Flood,24000000,0,4084232,-19915768,-82.98236666666666,-24000000,-100.0,tt8237644,3,XWW,en
2370,71,"Nov 16, 2018",Green Book,23000000,85080171,322034439,299034439,1300.1497347826087,62080171,269.91378695652173,tt6966692,20,CH,fr
2370,71,"Nov 16, 2018",Green Book,23000000,85080171,322034439,299034439,1300.1497347826087,62080171,269.91378695652173,tt6966692,2,CH,de
2370,71,"Nov 16, 2018",Green Book,23000000,85080171,322034439,299034439,1300.1497347826087,62080171,269.91378695652173,tt6966692,33,CH,it
2373,74,"Mar 17, 2000",Final Destination,23000000,53302314,112036870,89036870,387.1168260869565,30302314,131.74919130434785,tt5056454,2,XWW,en
2379,80,"Jan 10, 2014",Her,23000000,25568251,48163815,25163815,109.40789130434783,2568251,11.166308695652175,tt6889668,3,XWW,en
2385,86,"Feb 26, 2016",Eddie the Eagle,23000000,15789389,45060480,22060480,95.91513043478261,-7210611,-31.35048260869565,tt1083452,28,CA,en
2385,86,"Feb 26, 2016",Eddie the Eagle,23000000,15789389,45060480,22060480,95.91513043478261,-7210611,-31.35048260869565,tt1083452,35,IE,en
2385,86,"Feb 26, 2016",Eddie the Eagle,23000000,15789389,45060480,22060480,95.91513043478261,-7210611,-31.35048260869565,tt1083452,3,FI,sv
2396,97,"Jun 28, 2013",Redemption,23000000,36686,13593473,-9406527,-40.89794347826087,-22963314,-99.84049565217391,tt3104228,3,XWW,en
2396,97,"Jun 28, 2013",Redemption,23000000,36686,13593473,-9406527,-40.89794347826087,-22963314,-99.84049565217391,tt1893256,22,XWW,en
2396,97,"Jun 28, 2013",Redemption,23000000,36686,13593473,-9406527,-40.89794347826087,-22963314,-99.84049565217391,tt1893256,2,GB,en
2396,97,"Jun 28, 2013",Redemption,23000000,36686,13593473,-9406527,-40.89794347826087,-22963314,-99.84049565217391,tt8666442,4,XWW,en
2404,5,"Jul 13, 1990",Ghost,22000000,217631306,517600000,495600000,2252.7272727272725,195631306,889.2332090909091,tt1655400,4,XWW,en
2404,5,"Jul 13, 1990",Ghost,22000000,217631306,517600000,495600000,2252.7272727272725,195631306,889.2332090909091,tt4559932,4,XWW,en
2415,16,"Jul 28, 1995",The Net,22000000,50621733,110521733,88521733,402.3715136363636,28621733,130.09878636363638,tt5996202,7,XWW,en
2415,16,"Jul 28, 1995",The Net,22000000,50621733,110521733,88521733,402.3715136363636,28621733,130.09878636363638,tt6864720,1,XWW,en
2418,19,"Nov 11, 2005",Derailed,22000000,36020063,57520063,35520063,161.45483181818182,14020063,63.72755909090909,tt6173644,5,XWW,en
2424,25,"Aug 27, 2008",Traitor,22000000,23530831,27882226,5882226,26.73739090909091,1530831,6.958322727272727,tt1995390,14,XWW,en
2426,27,"May 19, 2017",Diary of a Wimpy Kid: The Long Haul,22000000,20738724,35609577,13609577,61.86171363636363,-1261276,-5.733072727272727,tt6003368,18,XWW,en
2428,29,"Nov 27, 2013",Homefront,22000000,20158492,51695362,29695362,134.9789181818182,-1841508,-8.37049090909091,tt2312718,24,CA,en
2449,50,"Oct 8, 2010",Stone,22000000,1810078,4065020,-17934980,-81.52263636363635,-20189922,-91.77237272727272,tt2156825,4,XWW,en
2449,50,"Oct 8, 2010",Stone,22000000,1810078,4065020,-17934980,-81.52263636363635,-20189922,-91.77237272727272,tt1423995,12,CA,fr
2449,50,"Oct 8, 2010",Stone,22000000,1810078,4065020,-17934980,-81.52263636363635,-20189922,-91.77237272727272,tt1423995,15,JP,en
2449,50,"Oct 8, 2010",Stone,22000000,1810078,4065020,-17934980,-81.52263636363635,-20189922,-91.77237272727272,tt1423995,5,IL,he
2452,53,"Jun 24, 1977",Sorcerer,21600000,12000000,12005968,-9594032,-44.41681481481481,-9600000,-44.44444444444444,tt7714510,3,XWW,en
2460,61,"Apr 5, 2019",Pet Sematary,21000000,54724696,109501146,88501146,421.4340285714286,33724696,160.59379047619046,tt0837563,6,XWW,en
2460,61,"Apr 5, 2019",Pet Sematary,21000000,54724696,109501146,88501146,421.4340285714286,33724696,160.59379047619046,tt0837563,8,US,en
3460,61,"Apr 21, 1989",Pet Sematary,11500000,57469179,57469179,45969179,399.73199130434784,45969179,399.73199130434784,tt0837563,6,XWW,en
3460,61,"Apr 21, 1989",Pet Sematary,11500000,57469179,57469179,45969179,399.73199130434784,45969179,399.73199130434784,tt0837563,8,US,en
2472,73,"Sep 22, 2017",Victoria and Abdul,21000000,22245070,68271146,47271146,225.10069523809523,1245070,5.928904761904762,tt5816682,4,XWW,en
2481,82,"Feb 1, 2019",Velvet Buzzsaw,21000000,0,0,-21000000,-100.0,-21000000,-100.0,tt7043012,4,XWW,en
2481,82,"Feb 1, 2019",Velvet Buzzsaw,21000000,0,0,-21000000,-100.0,-21000000,-100.0,tt7043012,6,US,en
2487,88,"Mar 22, 2019",Us,20000000,175006930,254210310,234210310,1171.05155,155006930,775.03465,tt2708782,3,XWW,en
2487,88,"Mar 22, 2019",Us,20000000,175006930,254210310,234210310,1171.05155,155006930,775.03465,tt6857112,1,US,en
2487,88,"Mar 22, 2019",Us,20000000,175006930,254210310,234210310,1171.05155,155006930,775.03465,tt6857112,3,XWW,en
2491,92,"Dec 9, 2016",La La Land,20000000,151101803,426351163,406351163,2031.755815,131101803,655.509015,tt3783958,14,IL,he
2491,92,"Dec 9, 2016",La La Land,20000000,151101803,426351163,406351163,2031.755815,131101803,655.509015,tt3783958,27,BG,bg
2491,92,"Dec 9, 2016",La La Land,20000000,151101803,426351163,406351163,2031.755815,131101803,655.509015,tt3783958,5,JM,en
2492,93,"Jul 19, 2013",The Conjuring,20000000,137400141,318000141,298000141,1490.000705,117400141,587.000705,tt1457767,1,XWW,en
2492,93,"Jul 19, 2013",The Conjuring,20000000,137400141,318000141,298000141,1490.000705,117400141,587.000705,tt1457767,2,CA,en
2492,93,"Jul 19, 2013",The Conjuring,20000000,137400141,318000141,298000141,1490.000705,117400141,587.000705,tt1457767,3,US,en
2497,98,"Oct 15, 2010",Jackass 3D,20000000,117229692,171685793,151685793,758.428965,97229692,486.14846,tt1116184,7,IL,he
2499,100,"Jan 18, 2019",Glass,20000000,111035005,245303505,225303505,1126.517525,91035005,455.17502500000006,tt6823368,18,TR,tr
2499,100,"Jan 18, 2019",Glass,20000000,111035005,245303505,225303505,1126.517525,91035005,455.17502500000006,tt6823368,20,US,en
2499,100,"Jan 18, 2019",Glass,20000000,111035005,245303505,225303505,1126.517525,91035005,455.17502500000006,tt6823368,4,XWW,en
2502,3,"Jul 2, 2014",Tammy,20000000,84525432,96407655,76407655,382.038275,64525432,322.62716,tt2103254,11,CA,fr
2511,12,"Apr 24, 2009",Obsessed,20000000,68261644,73964713,53964713,269.823565,48261644,241.30821999999998,tt3303730,2,XWW,en
2519,20,"Jun 3, 2016",Me Before You,20000000,56245075,208265198,188265198,941.32599,36245075,181.22537499999999,tt2674426,2,NZ,en
2519,20,"Jun 3, 2016",Me Before You,20000000,56245075,208265198,188265198,941.32599,36245075,181.22537499999999,tt2674426,31,CA,en
2519,20,"Jun 3, 2016",Me Before You,20000000,56245075,208265198,188265198,941.32599,36245075,181.22537499999999,tt2674426,32,IE,en
2520,21,"Feb 8, 2019",What Men Want,20000000,54611903,69911903,49911903,249.55951500000003,34611903,173.059515,tt7634968,16,US,en
2520,21,"Feb 8, 2019",What Men Want,20000000,54611903,69911903,49911903,249.55951500000003,34611903,173.059515,tt7634968,7,XWW,en
2524,25,"Jan 9, 2015",Selma,20000000,52076908,66776576,46776576,233.88288,32076908,160.38454,tt1020072,11,CA,fr
2524,25,"Jan 9, 2015",Selma,20000000,52076908,66776576,46776576,233.88288,32076908,160.38454,tt1020072,2,IL,he
2533,34,"Nov 6, 2015",Spotlight,20000000,45055776,92088460,72088460,360.4423,25055776,125.27888,tt1895587,15,IL,he
2535,36,"Jun 26, 2015",Max,20000000,42656255,43658157,23658157,118.29078500000001,22656255,113.28127500000001,tt3369806,7,CA,fr
2537,38,"Jul 24, 2009",Orphan,20000000,41596251,78769428,58769428,293.84714,21596251,107.981255,tt4746516,3,XWW,en
2538,39,"Nov 17, 2017",The Star,20000000,40847995,62758010,42758010,213.79005,20847995,104.239975,tt3924450,1,XWW,en
2564,65,"Aug 31, 2011",The Debt,20000000,31177548,46604054,26604054,133.02027,11177548,55.887739999999994,tt1630061,8,XWW,en
2564,65,"Aug 31, 2011",The Debt,20000000,31177548,46604054,26604054,133.02027,11177548,55.887739999999994,tt2698966,7,US,en
2565,66,"Oct 25, 2002",Ghost Ship,20000000,30113491,68349884,48349884,241.74942000000001,10113491,50.567454999999995,tt5389708,2,XWW,en
2573,74,"Jan 12, 1996",Eye for an Eye,20000000,26792700,26792700,6792700,33.9635,6792700,33.9635,tt7967412,2,US,en
2581,82,"Feb 14, 2014",Endless Love,20000000,23438250,34718173,14718173,73.59086500000001,3438250,17.19125,tt7188874,1,HK,en
2582,83,"Sep 8, 2006",The Covenant,20000000,23364784,38164784,18164784,90.82392,3364784,16.82392,tt7690762,3,XWW,en
2583,84,"Jul 1, 2011",Monte Carlo,20000000,23186769,39686769,19686769,98.43384499999999,3186769,15.933845,tt1067774,18,CA,fr
2583,84,"Jul 1, 2011",Monte Carlo,20000000,23186769,39686769,19686769,98.43384499999999,3186769,15.933845,tt1067774,4,TR,tr
2583,84,"Jul 1, 2011",Monte Carlo,20000000,23186769,39686769,19686769,98.43384499999999,3186769,15.933845,tt1067774,5,FI,sv
2598,99,"Jul 31, 1981",Under the Rainbow,20000000,18826490,18826490,-1173510,-5.86755,-1173510,-5.86755,tt2241691,15,XWW,en
2621,22,"Apr 13, 2012",Lockout,20000000,14326865,33943049,13943049,69.71524500000001,-5673135,-28.365675000000003,tt1592525,26,JP,en
2632,33,"Feb 26, 2016",Triple 9,20000000,12639297,25943792,5943792,29.71896,-7360703,-36.803515,tt1712261,6,CA,fr
2647,48,"Oct 27, 2017",Thank You for Your Service,20000000,9479390,9985316,-10014684,-50.07342,-10520610,-52.603049999999996,tt2776878,15,IE,en
2647,48,"Oct 27, 2017",Thank You for Your Service,20000000,9479390,9985316,-10014684,-50.07342,-10520610,-52.603049999999996,tt2776878,16,CA,en
2647,48,"Oct 27, 2017",Thank You for Your Service,20000000,9479390,9985316,-10014684,-50.07342,-10520610,-52.603049999999996,tt2776878,6,NZ,en
2667,68,"Dec 31, 2014",A Most Violent Year,20000000,5749134,8846875,-11153125,-55.765625,-14250866,-71.25433,tt2937898,23,TR,tr
2680,81,"Oct 26, 2018",Suspiria,20000000,2483472,7034615,-12965385,-64.826925,-17516528,-87.58264,tt1034415,11,CA,fr
2680,81,"Oct 26, 2018",Suspiria,20000000,2483472,7034615,-12965385,-64.826925,-17516528,-87.58264,tt1034415,14,XWW,en
2680,81,"Oct 26, 2018",Suspiria,20000000,2483472,7034615,-12965385,-64.826925,-17516528,-87.58264,tt1034415,2,IL,he
2680,81,"Oct 26, 2018",Suspiria,20000000,2483472,7034615,-12965385,-64.826925,-17516528,-87.58264,tt1034415,3,TR,tr
2681,82,"Nov 3, 2017",LBJ,20000000,2468683,2507181,-17492819,-87.464095,-17531317,-87.65658499999999,tt4778988,4,TR,tr
2688,89,"Dec 6, 2002",Equilibrium,20000000,1190018,5345869,-14654131,-73.27065499999999,-18809982,-94.04991,tt7263736,3,XWW,en
2696,97,"Nov 13, 2015",By the Sea,20000000,538460,3727746,-16272254,-81.36126999999999,-19461540,-97.3077,tt4301034,1,XWW,en
2706,7,"Dec 31, 2008",Admiral,20000000,0,38585047,18585047,92.925235,-20000000,-100.0,tt2544766,15,XWW,en
2707,8,"Dec 31, 2012",Zambezia,20000000,0,34454336,14454336,72.27168,-20000000,-100.0,tt1488181,17,IL,he
2718,19,"Dec 1, 2017",The Shape of Water,19500000,63859435,195790794,176290794,904.0553538461538,44359435,227.48428205128204,tt5580390,14,US,en
2718,19,"Dec 1, 2017",The Shape of Water,19500000,63859435,195790794,176290794,904.0553538461538,44359435,227.48428205128204,tt5580390,17,XWW,en
2739,40,"Jan 8, 2010",Leap Year,19000000,25918920,32618920,13618920,71.67852631578947,6918920,36.41536842105263,tt1537401,6,XWW,en
2746,47,"Jan 9, 1998",Firestorm,19000000,8123860,8123860,-10876140,-57.24284210526316,-10876140,-57.24284210526316,tt3341072,12,XWW,en
2746,47,"Jan 9, 1998",Firestorm,19000000,8123860,8123860,-10876140,-57.24284210526316,-10876140,-57.24284210526316,tt3341072,5,HK,en
2775,76,"Jun 12, 1987",Predator,18000000,59735548,98267558,80267558,445.9308777777777,41735548,231.86415555555558,tt3829266,25,TR,tr
2775,76,"Jun 12, 1987",Predator,18000000,59735548,98267558,80267558,445.9308777777777,41735548,231.86415555555558,tt3829266,7,BA,hr
2777,78,"Sep 11, 2015",The Perfect Guy,18000000,57027435,60278166,42278166,234.8787,39027435,216.81908333333334,tt3862750,14,IE,en
2777,78,"Sep 11, 2015",The Perfect Guy,18000000,57027435,60278166,42278166,234.8787,39027435,216.81908333333334,tt3862750,16,CA,en
2777,78,"Sep 11, 2015",The Perfect Guy,18000000,57027435,60278166,42278166,234.8787,39027435,216.81908333333334,tt3862750,2,NZ,en
2779,80,"Mar 25, 2011",Diary of a Wimpy Kid: Rodrick Rules,18000000,52698535,73695194,55695194,309.41774444444445,34698535,192.7696388888889,tt1650043,20,XWW,en
2782,83,"Apr 8, 2011",Soul Surfer,18000000,43853424,47158652,29158652,161.9925111111111,25853424,143.63013333333333,tt1596346,15,JP,en
2789,90,"Jul 26, 2013",Blue Jasmine,18000000,33404871,102912961,84912961,471.7386722222222,15404871,85.58261666666667,tt2334873,1,FI,sv
2791,92,"Dec 5, 2003",Honey,18000000,30272254,62646763,44646763,248.0375722222222,12272254,68.17918888888889,tt1571724,18,XWW,en
2791,92,"Dec 5, 2003",Honey,18000000,30272254,62646763,44646763,248.0375722222222,12272254,68.17918888888889,tt2357461,6,XWW,en
2791,92,"Dec 5, 2003",Honey,18000000,30272254,62646763,44646763,248.0375722222222,12272254,68.17918888888889,tt6861402,2,XWW,en
2795,96,"Dec 13, 1989",Glory,18000000,26593580,26593580,8593580,47.742111111111114,8593580,47.742111111111114,tt5937296,20,XWW,en
2803,4,"Apr 28, 2017",The Circle,18000000,20497844,40651864,22651864,125.84368888888888,2497844,13.876911111111113,tt2122313,5,XWW,en
2803,4,"Apr 28, 2017",The Circle,18000000,20497844,40651864,22651864,125.84368888888888,2497844,13.876911111111113,tt3148952,10,XWW,en
2803,4,"Apr 28, 2017",The Circle,18000000,20497844,40651864,22651864,125.84368888888888,2497844,13.876911111111113,tt3148952,8,XEU,en
2805,6,"Nov 5, 2010",127 Hours,18000000,18335230,60217171,42217171,234.5398388888889,335230,1.8623888888888889,tt1542344,32,CA,en
2810,11,"Aug 16, 2013",Jobs,18000000,16131410,43402515,25402515,141.12508333333332,-1868590,-10.381055555555555,tt2357129,13,CA,fr
2810,11,"Aug 16, 2013",Jobs,18000000,16131410,43402515,25402515,141.12508333333332,-1868590,-10.381055555555555,tt2357129,2,TR,tr
2824,25,"Jan 15, 2010",The Last Station,18000000,6617867,15696146,-2303854,-12.799188888888887,-11382133,-63.234072222222224,tt3436064,2,XWW,en
2833,34,"Dec 29, 1995",Restoration,18000000,4100000,4100000,-13900000,-77.22222222222223,-13900000,-77.22222222222223,tt1787663,4,XWW,en
2835,36,"Nov 25, 2016",Miss Sloane,18000000,3500605,7719630,-10280370,-57.11316666666667,-14499395,-80.55219444444445,tt4540710,16,IL,he
2838,39,"Feb 23, 1996",Unforgettable,18000000,2483790,2483790,-15516210,-86.20116666666667,-15516210,-86.20116666666667,tt5615904,2,XWW,en
3403,4,"Apr 21, 2017",Unforgettable,12000000,11368012,16221211,4221211,35.17675833333334,-631988,-5.266566666666667,tt5615904,2,XWW,en
2842,43,"Mar 1, 2013",Phantom,18000000,1034589,1199510,-16800490,-93.33605555555555,-16965411,-94.25228333333334,tt1922685,2,CA,en
2852,53,"Aug 22, 2014",The Prince,18000000,0,0,-18000000,-100.0,-18000000,-100.0,tt3918106,3,XWW,en
2852,53,"Aug 22, 2014",The Prince,18000000,0,0,-18000000,-100.0,-18000000,-100.0,tt4161288,3,XWW,en
2853,54,"Feb 19, 2016",Forsaken,18000000,0,0,-18000000,-100.0,-18000000,-100.0,tt2700194,2,XWW,en
2856,57,"Aug 17, 2007",Superbad,17500000,121463226,169955142,152455142,871.1722399999999,103963226,594.0755771428571,tt5529120,5,XWW,en
2874,75,"Sep 28, 2012",Pitch Perfect,17000000,65001093,116044347,99044347,582.613805882353,48001093,282.35937058823527,tt1981677,20,IL,he
2886,87,"Mar 4, 2011",Beastly,17000000,27865571,38028230,21028230,123.6954705882353,10865571,63.915123529411765,tt1152398,11,TR,tr
2886,87,"Mar 4, 2011",Beastly,17000000,27865571,38028230,21028230,123.6954705882353,10865571,63.915123529411765,tt1152398,19,IL,he
2903,4,"Aug 24, 2012",The Apparition,17000000,4936819,10637281,-6362719,-37.42775882352941,-12063181,-70.95988823529412,tt6559390,10,XWW,en
2906,7,"Dec 25, 2010",L'illusionniste,17000000,2231474,8609949,-8390051,-49.35324117647058,-14768526,-86.87368235294117,tt0775489,17,CA,fr
2906,7,"Dec 25, 2010",L'illusionniste,17000000,2231474,8609949,-8390051,-49.35324117647058,-14768526,-86.87368235294117,tt0775489,1,CH,fr
2911,12,"Jun 26, 2015",Escobar: Paradise Lost,17000000,195792,3917679,-13082321,-76.9548294117647,-16804208,-98.84828235294117,tt2515030,17,CA,en
2919,20,"Dec 11, 1987",Wall Street,16500000,43848100,43848100,27348100,165.7460606060606,27348100,165.7460606060606,tt1027718,28,JP,en
2921,22,"Aug 18, 2006",The Illusionist,16500000,39868642,83792062,67292062,407.83067878787875,23368642,141.62813333333332,tt0775489,8,XWW,en
2932,33,"May 25, 2012",Moonrise Kingdom,16000000,45512466,68848446,52848446,330.3027875,29512466,184.4529125,tt1748122,4,TR,tr
2948,49,"Jun 13, 2018",Superfly,16000000,20537137,20723581,4723581,29.522381250000002,4537137,28.35710625,tt7690670,7,CA,fr
2950,51,"Mar 12, 2010",Remember Me,16000000,19068240,56506120,40506120,253.16325,3068240,19.1765,tt2380307,34,JP,en
2970,71,"Apr 5, 2013",Trance,16000000,2322593,22594052,6594052,41.212824999999995,-13677407,-85.48379375,tt1924429,22,IL,he
5330,31,"Dec 31, 2012",Trance,950000,0,0,-950000,-100.0,-950000,-100.0,tt1924429,22,IL,he
2972,73,"Aug 15, 1997",Steel,16000000,1686429,1686429,-14313571,-89.45981875,-14313571,-89.45981875,tt2042443,2,XWW,en
2981,82,"Dec 31, 2013",Zulu,16000000,0,1844228,-14155772,-88.47357500000001,-16000000,-100.0,tt2249221,19,IL,he
2981,82,"Dec 31, 2013",Zulu,16000000,0,1844228,-14155772,-88.47357500000001,-16000000,-100.0,tt2249221,5,CA,fr
3001,2,"Aug 11, 2017",Annabelle: Creation,15000000,102092201,305384865,290384865,1935.8990999999999,87092201,580.6146733333334,tt5140878,4,SG,en
3001,2,"Aug 11, 2017",Annabelle: Creation,15000000,102092201,305384865,290384865,1935.8990999999999,87092201,580.6146733333334,tt5140878,8,NZ,en
3004,5,"Dec 18, 1985",The Color Purple,15000000,93589701,93589701,78589701,523.9313400000001,78589701,523.9313400000001,tt2241035,2,XWW,en
3008,9,"Jan 18, 2013",Mama,15000000,71628180,148095566,133095566,887.3037733333333,56628180,377.52119999999996,tt2023587,17,TR,tr
3008,9,"Jan 18, 2013",Mama,15000000,71628180,148095566,133095566,887.3037733333333,56628180,377.52119999999996,tt2023587,25,IL,he
3008,9,"Jan 18, 2013",Mama,15000000,71628180,148095566,133095566,887.3037733333333,56628180,377.52119999999996,tt2023587,6,CA,fr
3014,15,"Aug 31, 2007",Halloween,15000000,58269151,77514401,62514401,416.7626733333333,43269151,288.46100666666666,tt1502407,12,HK,en
3014,15,"Aug 31, 2007",Halloween,15000000,58269151,77514401,62514401,416.7626733333333,43269151,288.46100666666666,tt1502407,22,JP,en
3014,15,"Aug 31, 2007",Halloween,15000000,58269151,77514401,62514401,416.7626733333333,43269151,288.46100666666666,tt1502407,4,CA,fr
3014,15,"Aug 31, 2007",Halloween,15000000,58269151,77514401,62514401,416.7626733333333,43269151,288.46100666666666,tt1502407,9,IL,he
3535,36,"Oct 19, 2018",Halloween,10000000,159342015,254900667,244900667,2449.0066699999998,149342015,1493.42015,tt1502407,12,HK,en
3535,36,"Oct 19, 2018",Halloween,10000000,159342015,254900667,244900667,2449.0066699999998,149342015,1493.42015,tt1502407,22,JP,en
3535,36,"Oct 19, 2018",Halloween,10000000,159342015,254900667,244900667,2449.0066699999998,149342015,1493.42015,tt1502407,4,CA,fr
3535,36,"Oct 19, 2018",Halloween,10000000,159342015,254900667,244900667,2449.0066699999998,149342015,1493.42015,tt1502407,9,IL,he
5536,37,"Oct 17, 1978",Halloween,325000,47000000,70000000,69675000,21438.46153846154,46675000,14361.538461538461,tt1502407,12,HK,en
5536,37,"Oct 17, 1978",Halloween,325000,47000000,70000000,69675000,21438.46153846154,46675000,14361.538461538461,tt1502407,22,JP,en
5536,37,"Oct 17, 1978",Halloween,325000,47000000,70000000,69675000,21438.46153846154,46675000,14361.538461538461,tt1502407,4,CA,fr
5536,37,"Oct 17, 1978",Halloween,325000,47000000,70000000,69675000,21438.46153846154,46675000,14361.538461538461,tt1502407,9,IL,he
3027,28,"Dec 4, 2015",Krampus,15000000,42725475,61788393,46788393,311.92262,27725475,184.8365,tt3850590,7,CA,fr
3032,33,"Dec 3, 2014",Wild,15000000,37880356,52460543,37460543,249.73695333333333,22880356,152.53570666666667,tt5312232,3,XEU,en
3032,33,"Dec 3, 2014",Wild,15000000,37880356,52460543,37460543,249.73695333333333,22880356,152.53570666666667,tt7480724,3,XWW,en
3032,33,"Dec 3, 2014",Wild,15000000,37880356,52460543,37460543,249.73695333333333,22880356,152.53570666666667,tt8844252,4,XWW,en
3034,35,"Nov 7, 2014",The Theory of Everything,15000000,35893537,123327692,108327692,722.1846133333333,20893537,139.29024666666666,tt2980516,12,CA,en
3035,36,"Sep 16, 2011",Drive,15000000,35060689,81357930,66357930,442.3862,20060689,133.73792666666665,tt0780504,11,JP,en
3035,36,"Sep 16, 2011",Drive,15000000,35060689,81357930,66357930,442.3862,20060689,133.73792666666665,tt0780504,21,IL,he
3064,65,"Jan 15, 1993",Nowhere to Run,15000000,22189039,52189039,37189039,247.92692666666665,7189039,47.92692666666667,tt7526304,1,XWW,en
3069,70,"Apr 29, 2016",Keanu,15000000,20591853,20688141,5688141,37.920939999999995,5591853,37.27902,tt4139124,7,CA,fr
3080,81,"Feb 1, 2019",Miss Bala,15000000,14998027,15362298,362298,2.41532,-1973,-0.013153333333333333,tt5941692,5,XWW,en
3083,84,"Aug 19, 2011",One Day,15000000,13843771,59168692,44168692,294.45794666666666,-1156229,-7.708193333333334,tt1616203,3,XWW,en
3083,84,"Aug 19, 2011",One Day,15000000,13843771,59168692,44168692,294.45794666666666,-1156229,-7.708193333333334,tt4051858,2,XWW,en
3083,84,"Aug 19, 2011",One Day,15000000,13843771,59168692,44168692,294.45794666666666,-1156229,-7.708193333333334,tt8274146,4,XWW,en
3089,90,"Jan 20, 2017",The Founder,15000000,12786053,24403192,9403192,62.68794666666667,-2213947,-14.759646666666667,tt2262282,4,XWW,en
3114,15,"Jun 8, 2018",Hotel Artemis,15000000,6708137,12758799,-2241201,-14.94134,-8291863,-55.279086666666664,tt5834262,18,TR,tr
3142,43,"Feb 6, 2004",The Return,15000000,501752,5953886,-9046114,-60.307426666666665,-14498248,-96.65498666666666,tt1848871,4,CA,en
3142,43,"Feb 6, 2004",The Return,15000000,501752,5953886,-9046114,-60.307426666666665,-14498248,-96.65498666666666,tt4671306,4,XWW,en
3145,46,"Aug 27, 2010",Centurion,15000000,123570,7885048,-7114952,-47.433013333333335,-14876430,-99.17620000000001,tt1020558,1,CA,en
3145,46,"Aug 27, 2010",Centurion,15000000,123570,7885048,-7114952,-47.433013333333335,-14876430,-99.17620000000001,tt1020558,8,CA,fr
3149,50,"Sep 6, 2013",Winnie Mandela,15000000,61847,61847,-14938153,-99.58768666666667,-14938153,-99.58768666666667,tt1551641,2,ZA,en
3153,54,"Dec 6, 2013",Khumba,15000000,0,20898221,5898221,39.32147333333334,-15000000,-100.0,tt1487931,19,CA,fr
3157,58,"Dec 31, 2008",Bathory,15000000,0,3436763,-11563237,-77.08824666666668,-15000000,-100.0,tt2947556,1,XWW,en
3160,61,"Feb 17, 2017",In Dubious Battle,15000000,0,214182,-14785818,-98.57212,-15000000,-100.0,tt4411618,3,CA,en
3163,64,"Aug 14, 2019",Blinded by the Light,15000000,0,0,-15000000,-100.0,-15000000,-100.0,tt8266310,2,GB,en
3163,64,"Aug 14, 2019",Blinded by the Light,15000000,0,0,-15000000,-100.0,-15000000,-100.0,tt8266310,6,XWW,en
3165,66,"Jul 1, 2015",Magic Mike XXL,14500000,66013057,123660597,109160597,752.8317034482758,51513057,355.2624620689655,tt2268016,6,CA,fr
3165,66,"Jul 1, 2015",Magic Mike XXL,14500000,66013057,123660597,109160597,752.8317034482758,51513057,355.2624620689655,tt2268016,9,TR,tr
3167,68,"Jul 22, 2011",Elle s'appelait Sarah,14500000,7691700,25480031,10980031,75.72435172413793,-6808300,-46.95379310344828,tt1668200,13,CA,fr
3168,69,"Jun 5, 2015",Freedom,14500000,0,872757,-13627243,-93.98098620689656,-14500000,-100.0,tt10199670,1,XWW,en
3168,69,"Jun 5, 2015",Freedom,14500000,0,872757,-13627243,-93.98098620689656,-14500000,-100.0,tt4701906,1,XWW,en
3169,70,"Aug 7, 1992",Unforgiven,14400000,101157447,159157447,144757447,1005.2600486111111,86757447,602.4822708333334,tt2347134,3,XWW,en
3169,70,"Aug 7, 1992",Unforgiven,14400000,101157447,159157447,144757447,1005.2600486111111,86757447,602.4822708333334,tt7394636,1,XWW,en
3169,70,"Aug 7, 1992",Unforgiven,14400000,101157447,159157447,144757447,1005.2600486111111,86757447,602.4822708333334,tt6488508,1,XWW,en
3186,87,"Jan 18, 1991",White Fang,14000000,34729091,34729091,20729091,148.06493571428572,20729091,148.06493571428572,tt5222768,8,XWW,en
3188,89,"Oct 8, 1999",Superstar,14000000,30628981,30628981,16628981,118.77843571428572,16628981,118.77843571428572,tt1849111,3,BE,fr
3188,89,"Oct 8, 1999",Superstar,14000000,30628981,30628981,16628981,118.77843571428572,16628981,118.77843571428572,tt1849111,8,CA,fr
3188,89,"Oct 8, 1999",Superstar,14000000,30628981,30628981,16628981,118.77843571428572,16628981,118.77843571428572,tt2291904,2,XWW,en
3208,9,"Feb 2, 2001",Head Over Heels,14000000,10397365,10397365,-3602635,-25.733107142857143,-3602635,-25.733107142857143,tt1564916,4,XWW,en
3210,11,"Apr 23, 1999",Lost and Found,14000000,6552255,6552255,-7447745,-53.19817857142857,-7447745,-53.19817857142857,tt4269194,2,XWW,en
3215,16,"Oct 23, 2015",Suffragette,14000000,4702420,34044909,20044909,143.1779214285714,-9297580,-66.41128571428571,tt3077214,8,FI,sv
3217,18,"Dec 19, 2014",Mr. Turner,14000000,3958546,25187026,11187026,79.90732857142856,-10041454,-71.72467142857143,tt2473794,13,ZA,en
3217,18,"Dec 19, 2014",Mr. Turner,14000000,3958546,25187026,11187026,79.90732857142856,-10041454,-71.72467142857143,tt2473794,6,FI,sv
3227,28,"Nov 1, 2016",Reign of Assassins,14000000,0,11354230,-2645770,-18.89835714285714,-14000000,-100.0,tt1460743,12,XWW,en
3245,46,"Dec 3, 2010",Black Swan,13000000,106954678,331266710,318266710,2448.205461538462,93954678,722.7282923076923,tt0947798,20,CA,en
3245,46,"Dec 3, 2010",Black Swan,13000000,106954678,331266710,318266710,2448.205461538462,93954678,722.7282923076923,tt0947798,4,JP,en
3247,48,"Feb 11, 2011",Justin Bieber: Never Say Never,13000000,73013910,99034125,86034125,661.8009615384615,60013910,461.6454615384615,tt1702443,11,TR,tr
3251,52,"Jan 23, 2004",The Butterfly Effect,13000000,57924679,95638592,82638592,635.6814769230768,44924679,345.57445384615386,tt6112220,1,US,en
3251,52,"Jan 23, 2004",The Butterfly Effect,13000000,57924679,95638592,82638592,635.6814769230768,44924679,345.57445384615386,tt6112220,4,XWW,en
3253,54,"Jun 24, 2016",The Shallows,13000000,55121623,118763442,105763442,813.5649384615384,42121623,324.0124846153846,tt4052882,10,ES,ca
3275,76,"Mar 22, 2013",Admission,13000000,18007317,18733666,5733666,44.10512307692308,5007317,38.51782307692307,tt1814621,4,CA,fr
3287,88,"Sep 9, 2016",Robinson Crusoe,13000000,8005586,42446455,29446455,226.5111923076923,-4994414,-38.41856923076923,tt4731008,6,IL,he
3298,99,"Dec 4, 2015",Youth,13000000,2703296,24001573,11001573,84.62748461538462,-10296704,-79.20541538461538,tt2536448,3,XWW,en
3298,99,"Dec 4, 2015",Youth,13000000,2703296,24001573,11001573,84.62748461538462,-10296704,-79.20541538461538,tt6654316,6,XWW,en
3311,12,"Mar 30, 2012",Womb,13000000,0,0,-13000000,-100.0,-13000000,-100.0,tt1216520,2,XWW,en
3313,14,"Mar 15, 2013",The Call,12800000,51872378,69821476,57021476,445.48028124999996,39072378,305.252953125,tt2926868,3,XWW,en
3314,15,"Aug 5, 2016",Operation Chromite,12700000,1022720,49196532,36496532,287.3742677165354,-11677280,-91.94708661417323,tt4939066,1,PH,en
3314,15,"Aug 5, 2016",Operation Chromite,12700000,1022720,49196532,36496532,287.3742677165354,-11677280,-91.94708661417323,tt4939066,8,XWW,en
3315,16,"Sep 12, 2014",The Drop,12600000,10724389,19054534,6454534,51.22646031746032,-1875611,-14.885801587301586,tt1600196,15,CA,en
3317,18,"Sep 3, 2010",Machete,12500000,26593646,46370970,33870970,270.96776,14093646,112.74916800000001,tt0985694,15,FI,sv
3327,28,"Oct 15, 2010",Conviction,12500000,6797696,11826980,-673020,-5.3841600000000005,-5702304,-45.618432,tt1244754,14,CA,fr
3331,32,"Dec 17, 2010",Casino Jack,12500000,2039869,2272186,-10227814,-81.822512,-10460131,-83.681048,tt1194417,13,CA,fr
3346,47,"Dec 12, 1986",The Golden Child,12000000,79817937,79817937,67817937,565.149475,67817937,565.149475,tt3506476,3,XWW,en
3352,53,"Feb 8, 1985",Witness,12000000,65532576,65532576,53532576,446.1048,53532576,446.1048,tt2802196,1,XWW,en
3352,53,"Feb 8, 1985",Witness,12000000,65532576,65532576,53532576,446.1048,53532576,446.1048,tt8562562,2,XWW,en
3357,58,"Mar 2, 2012",Project X,12000000,54731865,103028188,91028188,758.5682333333334,42731865,356.098875,tt1636826,14,IL,he
3357,58,"Mar 2, 2012",Project X,12000000,54731865,103028188,91028188,758.5682333333334,42731865,356.098875,tt1636826,18,CA,en
3358,59,"Nov 10, 2017","Three Billboards Outside Ebbing, Missouri",12000000,54513740,160191915,148191915,1234.9326250000001,42513740,354.28116666666665,tt5027774,11,GB,en
3358,59,"Nov 10, 2017","Three Billboards Outside Ebbing, Missouri",12000000,54513740,160191915,148191915,1234.9326250000001,42513740,354.28116666666665,tt5027774,32,XWW,en
3359,60,"Nov 25, 2016",Lion,12000000,51739495,149570720,137570720,1146.4226666666666,39739495,331.16245833333335,tt3741834,3,CA,fr
3364,65,"Nov 22, 2013",Philomena,12000000,37709979,98963392,86963392,724.6949333333333,25709979,214.24982500000002,tt2431286,17,CA,fr
3364,65,"Nov 22, 2013",Philomena,12000000,37709979,98963392,86963392,724.6949333333333,25709979,214.24982500000002,tt2431286,9,IL,he
3366,67,"Feb 15, 2002",Crossroads,12000000,37188667,57000000,45000000,375.0,25188667,209.90555833333335,tt1842448,4,XWW,en
3366,67,"Feb 15, 2002",Crossroads,12000000,37188667,57000000,45000000,375.0,25188667,209.90555833333335,tt2219370,4,XWW,en
3366,67,"Feb 15, 2002",Crossroads,12000000,37188667,57000000,45000000,375.0,25188667,209.90555833333335,tt6603812,6,XWW,en
3366,67,"Feb 15, 2002",Crossroads,12000000,37188667,57000000,45000000,375.0,25188667,209.90555833333335,tt4080474,4,XWW,en
3366,67,"Feb 15, 2002",Crossroads,12000000,37188667,57000000,45000000,375.0,25188667,209.90555833333335,tt5459744,3,XWW,en
5485,86,"Jun 23, 2015",Crossroads,500000,0,0,-500000,-100.0,-500000,-100.0,tt1842448,4,XWW,en
5485,86,"Jun 23, 2015",Crossroads,500000,0,0,-500000,-100.0,-500000,-100.0,tt2219370,4,XWW,en
5485,86,"Jun 23, 2015",Crossroads,500000,0,0,-500000,-100.0,-500000,-100.0,tt6603812,6,XWW,en
5485,86,"Jun 23, 2015",Crossroads,500000,0,0,-500000,-100.0,-500000,-100.0,tt4080474,4,XWW,en
5485,86,"Jun 23, 2015",Crossroads,500000,0,0,-500000,-100.0,-500000,-100.0,tt5459744,3,XWW,en
3382,83,"Jun 15, 1979",Prophecy,12000000,22673340,22673340,10673340,88.9445,10673340,88.9445,tt3952226,1,XWW,en
3390,91,"Nov 15, 2013",Nebraska,12000000,17654912,24761360,12761360,106.34466666666667,5654912,47.124266666666664,tt1821549,10,CA,fr
3390,91,"Nov 15, 2013",Nebraska,12000000,17654912,24761360,12761360,106.34466666666667,5654912,47.124266666666664,tt1821549,1,IL,he
3396,97,"Jul 14, 2017",Wish Upon,12000000,14301505,23477345,11477345,95.64454166666667,2301505,19.179208333333335,tt5322012,7,SG,en
3406,7,"Oct 13, 2017",Marshall,12000000,10051659,10116816,-1883184,-15.6932,-1948341,-16.236175,tt5301662,3,CA,fr
3408,9,"Sep 14, 2012",Arbitrage,12000000,7919574,35830713,23830713,198.58927500000001,-4080426,-34.00355,tt1764183,32,CA,fr
3410,11,"May 12, 2000",Screwed,12000000,6982680,6982680,-5017320,-41.811,-5017320,-41.811,tt6577814,5,XWW,en
3412,13,"Sep 3, 1993",Fortress,12000000,6730578,46730578,34730578,289.42148333333336,-5269422,-43.91185,tt2607640,3,XWW,en
3426,27,"Mar 19, 1999",Ravenous,12000000,2062406,2062406,-9937594,-82.81328333333333,-9937594,-82.81328333333333,tt6243140,17,SG,en
3426,27,"Mar 19, 1999",Ravenous,12000000,2062406,2062406,-9937594,-82.81328333333333,-9937594,-82.81328333333333,tt6243140,21,CA,en
3426,27,"Mar 19, 1999",Ravenous,12000000,2062406,2062406,-9937594,-82.81328333333333,-9937594,-82.81328333333333,tt6243140,4,XWW,en
3431,32,"Mar 11, 2011",Kill the Irishman,12000000,1188194,1188194,-10811806,-90.09838333333333,-10811806,-90.09838333333333,tt1416801,1,CA,en
3432,33,"Sep 30, 2005",Duma,12000000,870067,994790,-11005210,-91.71008333333333,-11129933,-92.74944166666667,tt2112940,3,IL,ar
3435,36,"Jul 20, 2001",Brother,12000000,450594,450594,-11549406,-96.24504999999999,-11549406,-96.24504999999999,tt1588358,4,XWW,en
3435,36,"Jul 20, 2001",Brother,12000000,450594,450594,-11549406,-96.24504999999999,-11549406,-96.24504999999999,tt2343465,6,XWW,en
3435,36,"Jul 20, 2001",Brother,12000000,450594,450594,-11549406,-96.24504999999999,-11549406,-96.24504999999999,tt2903186,3,XWW,en
3445,46,"Oct 9, 2015",Trash,12000000,17484,6553186,-5446814,-45.39011666666667,-11982516,-99.8543,tt1921149,10,IL,he
3446,47,"Aug 19, 2011",5 Days of War,12000000,17479,87793,-11912207,-99.26839166666667,-11982521,-99.85434166666667,tt1486193,16,XWW,en
3459,60,"Nov 20, 2015",Carol,11800000,12711491,42843521,31043521,263.080686440678,911491,7.724499999999999,tt2402927,10,FI,sv
3459,60,"Nov 20, 2015",Carol,11800000,12711491,42843521,31043521,263.080686440678,911491,7.724499999999999,tt2402927,22,CA,fr
3459,60,"Nov 20, 2015",Carol,11800000,12711491,42843521,31043521,263.080686440678,911491,7.724499999999999,tt2402927,5,IL,he
3467,68,"Dec 10, 2010",The Fighter,11000000,93617009,129262388,118262388,1075.112618181818,82617009,751.0637181818182,tt0964517,22,JP,en
3478,79,"Nov 4, 2015",Brooklyn,11000000,38322743,62076141,51076141,464.3285545454545,27322743,248.38857272727273,tt2381111,10,IL,he
3478,79,"Nov 4, 2015",Brooklyn,11000000,38322743,62076141,51076141,464.3285545454545,27322743,248.38857272727273,tt2381111,11,CH,de
3478,79,"Nov 4, 2015",Brooklyn,11000000,38322743,62076141,51076141,464.3285545454545,27322743,248.38857272727273,tt2381111,17,CA,fr
3478,79,"Nov 4, 2015",Brooklyn,11000000,38322743,62076141,51076141,464.3285545454545,27322743,248.38857272727273,tt2381111,21,TR,tr
3478,79,"Nov 4, 2015",Brooklyn,11000000,38322743,62076141,51076141,464.3285545454545,27322743,248.38857272727273,tt2381111,2,CH,fr
3478,79,"Nov 4, 2015",Brooklyn,11000000,38322743,62076141,51076141,464.3285545454545,27322743,248.38857272727273,tt2381111,9,CH,it
3489,90,"Jan 11, 2013",Quartet,11000000,18388357,56178935,45178935,410.7175909090909,7388357,67.16688181818182,tt1441951,8,IL,he
3510,11,"Aug 26, 2011",Brighton Rock,11000000,229653,229653,-10770347,-97.91224545454546,-10770347,-97.91224545454546,tt1233192,11,IL,he
3513,14,"May 4, 2012",LOL,11000000,0,10431506,-568494,-5.168127272727273,-11000000,-100.0,tt1592873,16,IL,he
3513,14,"May 4, 2012",LOL,11000000,0,10431506,-568494,-5.168127272727273,-11000000,-100.0,tt1592873,4,ZA,en
3523,24,"Dec 25, 2004",Darkness,10600000,22163442,34409206,23809206,224.61515094339623,11563442,109.08907547169811,tt9110340,1,XWW,en
3523,24,"Dec 25, 2004",Darkness,10600000,22163442,34409206,23809206,224.61515094339623,11563442,109.08907547169811,tt3961040,2,XWW,en
3532,33,"Feb 18, 1983",Lovesick,10100000,10143618,10143618,43618,0.43186138613861386,43618,0.43186138613861386,tt2075241,2,XWW,en
3552,53,"Nov 3, 2017",Lady Bird,10000000,48958273,78610769,68610769,686.1076899999999,38958273,389.58273,tt4925292,10,IL,he
3552,53,"Nov 3, 2017",Lady Bird,10000000,48958273,78610769,68610769,686.1076899999999,38958273,389.58273,tt4925292,4,CA,fr
3568,69,"Oct 4, 1985",Commando,10000000,35073978,35073978,25073978,250.73978000000002,25073978,250.73978000000002,tt6878378,7,IN,kn
3570,71,"Sep 17, 2010",Devil,10000000,33679655,63354114,53354114,533.54114,23679655,236.79655,tt1314655,27,JP,en
3570,71,"Sep 17, 2010",Devil,10000000,33679655,63354114,53354114,533.54114,23679655,236.79655,tt7442358,2,XWW,en
3579,80,"Aug 10, 2018",Slender Man,10000000,30564825,51723644,41723644,417.23644,20564825,205.64825,tt5690360,17,IL,he
3591,92,"Jan 8, 2016",The Forest,10000000,26594261,40749230,30749230,307.4923,16594261,165.94261,tt2364649,2,XWW,en
3591,92,"Jan 8, 2016",The Forest,10000000,26594261,40749230,30749230,307.4923,16594261,165.94261,tt3592218,1,XEU,en
3591,92,"Jan 8, 2016",The Forest,10000000,26594261,40749230,30749230,307.4923,16594261,165.94261,tt3592218,2,XWW,en
3595,96,"Aug 17, 2012",Sparkle,10000000,24397469,24660323,14660323,146.60323,14397469,143.97469,tt1876451,10,CA,fr
3597,98,"Apr 26, 2013",Mud,10000000,21590086,31556959,21556959,215.56959,11590086,115.90086,tt2514592,2,XWW,en
3600,1,"Sep 16, 2016",Blair Witch,10000000,20777061,38985577,28985577,289.85577,10777061,107.77060999999999,tt1540011,19,XWW,en
3600,1,"Sep 16, 2016",Blair Witch,10000000,20777061,38985577,28985577,289.85577,10777061,107.77060999999999,tt1540011,6,CA,en
3602,3,"Feb 2, 2001",Valentine,10000000,20384136,20384136,10384136,103.84136,10384136,103.84136,tt5474224,2,XWW,en
3612,13,"Jan 19, 1990",Tremors,10000000,16667084,16667084,6667084,66.67084,6667084,66.67084,tt7128732,3,XWW,en
3627,28,"Dec 19, 2000",The Gift,10000000,12008642,44567606,34567606,345.67606,2008642,20.08642,tt3474788,5,XWW,en
3627,28,"Dec 19, 2000",The Gift,10000000,12008642,44567606,34567606,345.67606,2008642,20.08642,tt3474788,6,GB,en
3627,28,"Dec 19, 2000",The Gift,10000000,12008642,44567606,34567606,345.67606,2008642,20.08642,tt8789628,1,XWW,en
4262,63,"Aug 7, 2015",The Gift,5000000,43787265,58978477,53978477,1079.56954,38787265,775.7453,tt3474788,5,XWW,en
4262,63,"Aug 7, 2015",The Gift,5000000,43787265,58978477,53978477,1079.56954,38787265,775.7453,tt3474788,6,GB,en
4262,63,"Aug 7, 2015",The Gift,5000000,43787265,58978477,53978477,1079.56954,38787265,775.7453,tt8789628,1,XWW,en
3632,33,"Jul 23, 1999",Drop Dead Gorgeous,10000000,10571408,10571408,571408,5.71408,571408,5.71408,tt4543578,1,XWW,en
3633,34,"Apr 5, 2019",The Best of Enemies,10000000,10205616,10205616,205616,2.0561599999999998,205616,2.0561599999999998,tt4807408,1,XWW,en
3633,34,"Apr 5, 2019",The Best of Enemies,10000000,10205616,10205616,205616,2.0561599999999998,205616,2.0561599999999998,tt4807408,2,US,en
3641,42,"May 21, 2010",MacGruber,10000000,8525600,8629895,-1370105,-13.70105,-1474400,-14.743999999999998,tt1470023,9,CA,fr
3644,45,"Mar 27, 2015",While We're Young,10000000,7582065,17503828,7503828,75.03828,-2417935,-24.17935,tt1791682,24,CH,fr
3644,45,"Mar 27, 2015",While We're Young,10000000,7582065,17503828,7503828,75.03828,-2417935,-24.17935,tt1791682,3,TR,tr
3644,45,"Mar 27, 2015",While We're Young,10000000,7582065,17503828,7503828,75.03828,-2417935,-24.17935,tt1791682,6,CH,de
3658,59,"Mar 20, 2015",Danny Collins,10000000,5637066,8465845,-1534155,-15.341550000000002,-4362934,-43.62934,tt1772288,11,TR,tr
3658,59,"Mar 20, 2015",Danny Collins,10000000,5637066,8465845,-1534155,-15.341550000000002,-4362934,-43.62934,tt1772288,9,IL,he
3660,61,"Apr 5, 2000",Black and White,10000000,5241315,5241315,-4758685,-47.586850000000005,-4758685,-47.586850000000005,tt1636833,3,XWW,en
3662,63,"Oct 26, 2001",On the Line,10000000,4365455,4690802,-5309198,-53.09198000000001,-5634545,-56.34545,tt2076875,1,XWW,en
3667,68,"Oct 14, 2016",Max Steel,10000000,3818664,4563080,-5436920,-54.36919999999999,-6181336,-61.813359999999996,tt1472584,4,IL,he
3673,74,"Nov 14, 2014",Rosewater,10000000,3128941,3185717,-6814283,-68.14283,-6871059,-68.71059000000001,tt2752688,10,CA,fr
3673,74,"Nov 14, 2014",Rosewater,10000000,3128941,3185717,-6814283,-68.14283,-6871059,-68.71059000000001,tt2752688,6,TR,tr
3683,84,"Jun 24, 2011",A Better Life,10000000,1759252,1884251,-8115749,-81.15749,-8240748,-82.40747999999999,tt2027265,10,XWW,en
3683,84,"Jun 24, 2011",A Better Life,10000000,1759252,1884251,-8115749,-81.15749,-8240748,-82.40747999999999,tt2027265,6,CA,en
3689,90,"Jul 27, 2012",Killer Joe,10000000,1291645,4659110,-5340890,-53.4089,-8708355,-87.08355,tt1726669,17,IE,en
3689,90,"Jul 27, 2012",Killer Joe,10000000,1291645,4659110,-5340890,-53.4089,-8708355,-87.08355,tt1726669,1,JP,en
3689,90,"Jul 27, 2012",Killer Joe,10000000,1291645,4659110,-5340890,-53.4089,-8708355,-87.08355,tt1726669,7,CA,en
3690,91,"Jun 2, 2017",Churchill,10000000,1279681,7582196,-2417804,-24.17804,-8720319,-87.20318999999999,tt2674454,2,CA,fr
3690,91,"Jun 2, 2017",Churchill,10000000,1279681,7582196,-2417804,-24.17804,-8720319,-87.20318999999999,tt2674454,8,TR,tr
3698,99,"Jan 20, 2012",Coriolanus,10000000,749641,2179623,-7820377,-78.20376999999999,-9250359,-92.50359,tt1372686,13,CA,fr
3698,99,"Jan 20, 2012",Coriolanus,10000000,749641,2179623,-7820377,-78.20376999999999,-9250359,-92.50359,tt1372686,16,IL,he
3699,100,"Oct 4, 2013",Parkland,10000000,641439,1616353,-8383647,-83.83646999999999,-9358561,-93.58561,tt2345112,4,CA,fr
3716,17,"Jul 14, 2006",Edmond,10000000,131719,241719,-9758281,-97.58281,-9868281,-98.68281,tt7201846,8,CA,fr
3731,32,"Dec 26, 2014",Barbecue,10000000,388,247565,-9752435,-97.52435,-9999612,-99.99612,tt3202120,11,IL,he
3731,32,"Dec 26, 2014",Barbecue,10000000,388,247565,-9752435,-97.52435,-9999612,-99.99612,tt3202120,6,CA,fr
3747,48,"Sep 22, 2017",Friend Request,9900000,3759078,11310835,1410835,14.250858585858586,-6140922,-62.02951515151515,tt3352390,13,CA,fr
3750,51,"Dec 19, 2012",Amour,9700000,6738954,36787044,27087044,279.24787628865977,-2961046,-30.526247422680413,tt1602620,20,CA,fr
3755,56,"Dec 21, 2016",Dangal,9500000,12391761,294654618,285154618,3001.627557894737,2891761,30.439589473684208,tt5074352,7,TR,tr
3761,62,"Nov 11, 2011",Melancholia,9400000,3030848,21817298,12417298,132.09891489361704,-6369152,-67.75693617021277,tt1527186,17,IL,he
3761,62,"Nov 11, 2011",Melancholia,9400000,3030848,21817298,12417298,132.09891489361704,-6369152,-67.75693617021277,tt1527186,22,JP,en
3761,62,"Nov 11, 2011",Melancholia,9400000,3030848,21817298,12417298,132.09891489361704,-6369152,-67.75693617021277,tt5797456,3,XWW,en
3766,67,"Dec 31, 2011",Red Dog,9100000,0,20927794,11827794,129.97575824175826,-9100000,-100.0,tt4706780,4,XWW,en
3774,75,"Oct 21, 2016",Ouija: Origin of Evil,9000000,35144505,81831866,72831866,809.2429555555557,26144505,290.4945,tt4361050,17,XWW,en
3777,78,"Feb 13, 2019",Happy Death Day 2U,9000000,28051045,64179495,55179495,613.1055,19051045,211.6782777777778,tt8155288,7,XWW,en
3777,78,"Feb 13, 2019",Happy Death Day 2U,9000000,28051045,64179495,55179495,613.1055,19051045,211.6782777777778,tt8155288,9,US,en
3786,87,"Dec 2, 2016",Jackie,9000000,13960394,36588512,27588512,306.53902222222223,4960394,55.11548888888888,tt2108546,1,IL,he
3786,87,"Dec 2, 2016",Jackie,9000000,13960394,36588512,27588512,306.53902222222223,4960394,55.11548888888888,tt1619029,10,CA,fr
3786,87,"Dec 2, 2016",Jackie,9000000,13960394,36588512,27588512,306.53902222222223,4960394,55.11548888888888,tt1619029,1,FI,sv
3786,87,"Dec 2, 2016",Jackie,9000000,13960394,36588512,27588512,306.53902222222223,4960394,55.11548888888888,tt1619029,3,IL,he
3791,92,"Nov 4, 2016",Loving,9000000,7710234,12898064,3898064,43.311822222222226,-1289766,-14.330733333333335,tt2495212,1,XWW,en
3791,92,"Nov 4, 2016",Loving,9000000,7710234,12898064,3898064,43.311822222222226,-1289766,-14.330733333333335,tt5479616,3,XWW,en
3791,92,"Nov 4, 2016",Loving,9000000,7710234,12898064,3898064,43.311822222222226,-1289766,-14.330733333333335,tt4669986,2,IL,he
3804,5,"Dec 25, 2018",Destroyer,9000000,1533324,3681096,-5318904,-59.098933333333335,-7466676,-82.96306666666666,tt7137380,7,TR,tr
3811,12,"May 6, 2016",Dheepan,9000000,248795,7704357,-1295643,-14.396033333333333,-8751205,-97.23561111111111,tt4082068,12,FI,sv
3811,12,"May 6, 2016",Dheepan,9000000,248795,7704357,-1295643,-14.396033333333333,-8751205,-97.23561111111111,tt4082068,15,TR,tr
3811,12,"May 6, 2016",Dheepan,9000000,248795,7704357,-1295643,-14.396033333333333,-8751205,-97.23561111111111,tt4082068,1,CA,fr
3811,12,"May 6, 2016",Dheepan,9000000,248795,7704357,-1295643,-14.396033333333333,-8751205,-97.23561111111111,tt4082068,7,IL,he
3813,14,"Oct 25, 2002",All or Nothing,9000000,184255,184255,-8815745,-97.95272222222222,-8815745,-97.95272222222222,tt3868240,4,XWW,en
3819,20,"Jun 17, 2014",Beneath Hill 60,9000000,0,3440939,-5559061,-61.76734444444445,-9000000,-100.0,tt1418646,13,CA,en
3819,20,"Jun 17, 2014",Beneath Hill 60,9000000,0,3440939,-5559061,-61.76734444444445,-9000000,-100.0,tt1418646,16,IE,en
3819,20,"Jun 17, 2014",Beneath Hill 60,9000000,0,3440939,-5559061,-61.76734444444445,-9000000,-100.0,tt1418646,2,NZ,en
3823,24,"May 18, 2012",Polisse,8900000,176988,22744132,13844132,155.55204494382022,-8723012,-98.01137078651685,tt1661420,14,CA,fr
3823,24,"May 18, 2012",Polisse,8900000,176988,22744132,13844132,155.55204494382022,-8723012,-98.01137078651685,tt1661420,9,BE,fr
3828,29,"Nov 30, 2007",Awake,8600000,14373825,32968648,24368648,283.35637209302325,5773825,67.1375,tt7584702,2,CA,en
3835,36,"Jan 16, 2019",Dragon Ball Super: Broly,8500000,30376755,122747755,114247755,1344.0912352941175,21876755,257.3735882352941,tt7961060,20,XWW,en
3835,36,"Jan 16, 2019",Dragon Ball Super: Broly,8500000,30376755,122747755,114247755,1344.0912352941175,21876755,257.3735882352941,tt7961060,22,XWW,es
3841,42,"Mar 9, 2007",The Namesake,8500000,13610521,20288774,11788774,138.6914588235294,5110521,60.12377647058823,tt7106782,3,XWW,en
3867,68,"Aug 8, 1986",Stand by Me,8000000,52287414,52287414,44287414,553.592675,44287414,553.592675,tt1883187,2,HK,en
3867,68,"Aug 8, 1986",Stand by Me,8000000,52287414,52287414,44287414,553.592675,44287414,553.592675,tt8383596,3,XWW,en
3871,72,"May 3, 2019",The Intruder,8000000,35095904,36005871,28005871,350.07338749999997,27095904,338.6988,tt1773741,7,XWW,en
3871,72,"May 3, 2019",The Intruder,8000000,35095904,36005871,28005871,350.07338749999997,27095904,338.6988,tt3973502,3,CA,en
3872,73,"Sep 30, 2011",50/50,8000000,35016118,41334735,33334735,416.6841875,27016118,337.70147499999996,tt1306980,1,FI,sv
3872,73,"Sep 30, 2011",50/50,8000000,35016118,41334735,33334735,416.6841875,27016118,337.70147499999996,tt1306980,16,BG,bg
3872,73,"Sep 30, 2011",50/50,8000000,35016118,41334735,33334735,416.6841875,27016118,337.70147499999996,tt1306980,8,CA,fr
3875,76,"Oct 11, 2002",Brown Sugar,8000000,27362712,28315272,20315272,253.9409,19362712,242.0339,tt2675102,3,XWW,en
3881,82,"May 7, 1993",Much Ado About Nothing,8000000,22549338,22549338,14549338,181.866725,14549338,181.866725,tt4650738,1,XWW,en
3905,6,"Dec 30, 2015",Anomalisa,8000000,3759286,5706168,-2293832,-28.672900000000002,-4240714,-53.008925,tt2401878,10,IL,he
3907,8,"Dec 29, 2010",Another Year,8000000,3205706,20005613,12005613,150.0701625,-4794294,-59.928675,tt3508808,4,XWW,en
3907,8,"Dec 29, 2010",Another Year,8000000,3205706,20005613,12005613,150.0701625,-4794294,-59.928675,tt5886728,4,XWW,en
3912,13,"Apr 6, 2018",Lean on Pete,8000000,1163056,2455027,-5544973,-69.3121625,-6836944,-85.4618,tt5340300,12,TR,tr
3915,16,"May 3, 2019",El Chicano,8000000,700261,700261,-7299739,-91.2467375,-7299739,-91.2467375,tt7374952,2,US,en
3935,36,"Apr 27, 2001",Akira,8000000,19585,19585,-7980415,-99.75518749999999,-7980415,-99.75518749999999,tt5465370,3,IN,hi
3951,52,"Apr 14, 2015",Loin des hommes,7700000,5336,1080428,-6619572,-85.96846753246753,-7694664,-99.9307012987013,tt2936180,18,CA,fr
3966,67,"Dec 21, 2011",Albert Nobbs,7500000,3014696,8539003,1039003,13.853373333333332,-4485304,-59.80405333333333,tt1602098,13,IL,he
3967,68,"Jun 24, 2016",The Neon Demon,7500000,1333124,3559803,-3940197,-52.53596,-6166876,-82.22501333333334,tt1974419,25,XWW,en
3987,88,"Jun 29, 2012",Magic Mike,7000000,113721571,170549753,163549753,2336.4250428571427,106721571,1524.5938714285714,tt1915581,19,IL,he
3990,91,"Mar 15, 2019",Five Feet Apart,7000000,45729221,80504421,73504421,1050.0631571428573,38729221,553.2745857142858,tt6472976,16,US,en
3990,91,"Mar 15, 2019",Five Feet Apart,7000000,45729221,80504421,73504421,1050.0631571428573,38729221,553.2745857142858,tt6472976,9,XWW,en
4003,4,"Apr 7, 2017",Gifted,7000000,24801212,36964656,29964656,428.0665142857143,17801212,254.3030285714286,tt4023894,3,XWW,en
4010,11,"Jun 19, 2015",Dope,7000000,17506470,18190831,11190831,159.8690142857143,10506470,150.09242857142857,tt3850214,5,CA,fr
4020,21,"Oct 10, 2003",House of the Dead,7000000,10199354,13860078,6860078,98.00111428571428,3199354,45.70505714285714,tt1841642,16,IE,en
4026,27,"Jun 18, 2010",Cyrus,7000000,7468936,10062896,3062896,43.75565714285714,468936,6.699085714285714,tt1336617,1,TR,tr
4026,27,"Jun 18, 2010",Cyrus,7000000,7468936,10062896,3062896,43.75565714285714,468936,6.699085714285714,tt1336617,4,CA,fr
4042,43,"Jan 13, 2012",We Need to Talk About Kevin,7000000,1738692,10765283,3765283,53.78975714285714,-5261308,-75.16154285714286,tt1242460,22,HK,en
4043,44,"Feb 2, 2007",Factory Girl,7000000,1661464,1661464,-5338536,-76.2648,-5338536,-76.2648,tt3182596,5,XWW,en
4051,52,"Apr 2, 2014",Dom Hemingway,7000000,523511,1857458,-5142542,-73.46488571428571,-6476489,-92.52127142857142,tt2402105,11,LU,fr
4051,52,"Apr 2, 2014",Dom Hemingway,7000000,523511,1857458,-5142542,-73.46488571428571,-6476489,-92.52127142857142,tt2402105,14,IL,he
4051,52,"Apr 2, 2014",Dom Hemingway,7000000,523511,1857458,-5142542,-73.46488571428571,-6476489,-92.52127142857142,tt2402105,4,CA,fr
4051,52,"Apr 2, 2014",Dom Hemingway,7000000,523511,1857458,-5142542,-73.46488571428571,-6476489,-92.52127142857142,tt2402105,5,TR,tr
4053,54,"May 13, 2011",Hesher,7000000,382946,382946,-6617054,-94.52934285714286,-6617054,-94.52934285714286,tt1403177,2,CA,fr
4055,56,"Feb 14, 2003",Gerry,7000000,254683,719699,-6280301,-89.71858571428571,-6745317,-96.36167142857143,tt1708473,2,CA,fr
4063,64,"Aug 18, 2015",Z Storm,7000000,0,2053330,-4946670,-70.66671428571428,-7000000,-100.0,tt3469440,1,XWW,en
4063,64,"Aug 18, 2015",Z Storm,7000000,0,2053330,-4946670,-70.66671428571428,-7000000,-100.0,tt3469440,5,HK,en
4065,66,"Jul 23, 2013",Twixt,7000000,0,1268346,-5731654,-81.88077142857144,-7000000,-100.0,tt1756851,8,CA,fr
4075,76,"Sep 17, 2010",Incendies,6800000,6857096,16038343,9238343,135.85798529411767,57096,0.8396470588235293,tt1255953,20,CA,fr
4083,84,"Oct 3, 2014",Annabelle,6500000,84273813,256862920,250362920,3851.7372307692303,77773813,1196.5202,tt3322940,1,CA,fr
4083,84,"Oct 3, 2014",Annabelle,6500000,84273813,256862920,250362920,3851.7372307692303,77773813,1196.5202,tt3322940,22,IL,he
4083,84,"Oct 3, 2014",Annabelle,6500000,84273813,256862920,250362920,3851.7372307692303,77773813,1196.5202,tt3322940,9,TR,tr
4096,97,"Dec 2, 2011",Shame,6500000,4002293,20412841,13912841,214.04370769230766,-2497707,-38.42626153846154,tt3009444,3,XWW,en
4100,1,"Nov 13, 2009",The Messenger,6500000,1109660,1744952,-4755048,-73.1545846153846,-5390340,-82.92830769230768,tt4459890,3,XWW,en
4100,1,"Nov 13, 2009",The Messenger,6500000,1109660,1744952,-4755048,-73.1545846153846,-5390340,-82.92830769230768,tt8706988,1,XWW,en
4102,3,"Aug 17, 2001",Aberdeen,6500000,64148,64148,-6435852,-99.01310769230768,-6435852,-99.01310769230768,tt3429014,1,HK,en
4102,3,"Aug 17, 2001",Aberdeen,6500000,64148,64148,-6435852,-99.01310769230768,-6435852,-99.01310769230768,tt3429014,2,XWW,en
4106,7,"Oct 10, 2007",Control,6400000,871577,8902141,2502141,39.095953125,-5528423,-86.381609375,tt1727497,7,XWW,en
4106,7,"Oct 10, 2007",Control,6400000,871577,8902141,2502141,39.095953125,-5528423,-86.381609375,tt2550112,3,XWW,en
4106,7,"Oct 10, 2007",Control,6400000,871577,8902141,2502141,39.095953125,-5528423,-86.381609375,tt2550112,5,HK,en
4117,18,"Sep 19, 1980",Ordinary People,6000000,52302978,52302978,46302978,771.7163,46302978,771.7163,tt5891626,5,XWW,en
4135,36,"Feb 8, 2019",The Prodigy,6000000,14856291,19789712,13789712,229.82853333333333,8856291,147.60485,tt4504044,15,US,en
4135,36,"Feb 8, 2019",The Prodigy,6000000,14856291,19789712,13789712,229.82853333333333,8856291,147.60485,tt4504044,8,XWW,en
4147,48,"Apr 27, 2012",Bernie,6000000,9204489,10106975,4106975,68.44958333333334,3204489,53.40815,tt1704573,11,HK,en
4147,48,"Apr 27, 2012",Bernie,6000000,9204489,10106975,4106975,68.44958333333334,3204489,53.40815,tt1704573,2,CA,fr
4162,63,"Mar 14, 2014",Veronica Mars,6000000,3322127,3485383,-2514617,-41.91028333333333,-2677873,-44.63121666666667,tt2771372,7,CA,fr
4170,71,"Sep 14, 2018",Mandy,6000000,1214525,1427656,-4572344,-76.20573333333334,-4785475,-79.75791666666666,tt6998518,14,CA,fr
4190,91,"Feb 9, 2010",Icarus,6000000,0,0,-6000000,-100.0,-6000000,-100.0,tt1261862,13,CA,en
4190,91,"Feb 9, 2010",Icarus,6000000,0,0,-6000000,-100.0,-6000000,-100.0,tt1261862,1,CA,fr
4196,97,"Aug 2, 1996",Emma,5900000,22231658,37831658,31931658,541.2145423728814,16331658,276.8077627118644,tt6523174,4,JP,en
4217,18,"Sep 27, 2013",Don Jon,5500000,24477704,41268579,35768579,650.3378,18977704,345.04916363636363,tt2229499,14,CA,fr
4217,18,"Sep 27, 2013",Don Jon,5500000,24477704,41268579,35768579,650.3378,18977704,345.04916363636363,tt2229499,18,IR,fa
4225,26,"Oct 3, 2003",Wonderland,5500000,1060512,1060512,-4439488,-80.71796363636363,-4439488,-80.71796363636363,tt4444762,6,XWW,en
4225,26,"Oct 3, 2003",Wonderland,5500000,1060512,1060512,-4439488,-80.71796363636363,-4439488,-80.71796363636363,tt6571636,5,XWW,en
4225,26,"Oct 3, 2003",Wonderland,5500000,1060512,1060512,-4439488,-80.71796363636363,-4439488,-80.71796363636363,tt5430020,4,XWW,en
4228,29,"Oct 21, 2011",Le Havre,5500000,611709,13480196,7980196,145.09447272727272,-4888291,-88.87801818181819,tt1508675,26,FI,sv
4232,33,"May 5, 2015",Miss Julie,5500000,0,863895,-4636105,-84.29281818181819,-5500000,-100.0,tt2298738,2,XWW,en
4233,34,"Dec 31, 2008",Animals,5500000,0,0,-5500000,-100.0,-5500000,-100.0,tt6510634,6,XWW,en
4233,34,"Dec 31, 2008",Animals,5500000,0,0,-5500000,-100.0,-5500000,-100.0,tt4426738,3,GB,en
4233,34,"Dec 31, 2008",Animals,5500000,0,0,-5500000,-100.0,-5500000,-100.0,tt4426738,4,XWW,en
4243,44,"Aug 1, 1944",Wilson,5200000,2000000,2000000,-3200000,-61.53846153846154,-3200000,-61.53846153846154,tt1781058,8,CA,fr
4248,49,"Feb 24, 2017",Get Out,5000000,176040665,255367951,250367951,5007.35902,171040665,3420.8133,tt5052448,16,XWW,en
4249,50,"Jan 20, 2017",Split,5000000,138141585,278964806,273964806,5479.29612,133141585,2662.8316999999997,tt4972582,17,IL,he
4249,50,"Jan 20, 2017",Split,5000000,138141585,278964806,273964806,5479.29612,133141585,2662.8316999999997,tt4972582,25,XWW,en
4250,51,"Oct 21, 2011",Paranormal Activity 3,5000000,104028807,207039844,202039844,4040.79688,99028807,1980.5761400000001,tt1778304,24,TR,tr
4250,51,"Oct 21, 2011",Paranormal Activity 3,5000000,104028807,207039844,202039844,4040.79688,99028807,1980.5761400000001,tt1778304,9,JP,en
4253,54,"Mar 11, 2016",10 Cloverfield Lane,5000000,72082999,108286422,103286422,2065.7284400000003,67082999,1341.65998,tt1179933,28,CA,fr
4254,55,"Jul 22, 2016",Lights Out,5000000,67268835,148806510,143806510,2876.1302,62268835,1245.3766999999998,tt1646127,2,XWW,en
4255,56,"Sep 11, 2015",The Visit,5000000,65206105,98677816,93677816,1873.5563200000001,60206105,1204.1221,tt5105216,1,XWW,en
4258,59,"Oct 19, 2012",Paranormal Activity 4,5000000,53900335,142817992,137817992,2756.35984,48900335,978.0067,tt2109184,25,TR,tr
4259,60,"Oct 24, 2014",Ouija,5000000,50856010,103300632,98300632,1966.01264,45856010,917.1202,tt1204977,24,CA,fr
4268,69,"Dec 24, 2003",Monster,5000000,34469210,64240813,59240813,1184.81626,29469210,589.3842000000001,tt2762040,1,XWW,en
4268,69,"Dec 24, 2003",Monster,5000000,34469210,64240813,59240813,1184.81626,29469210,589.3842000000001,tt3589450,1,XWW,en
4268,69,"Dec 24, 2003",Monster,5000000,34469210,64240813,59240813,1184.81626,29469210,589.3842000000001,tt3024404,2,XWW,en
4271,72,"Apr 11, 2014",Oculus,5000000,27695246,44115496,39115496,782.3099199999999,22695246,453.90492,tt2388715,6,CA,fr
4273,74,"Aug 26, 2015",No Escape,5000000,27288872,42844516,37844516,756.89032,22288872,445.77744,tt1781922,1,IE,en
4273,74,"Aug 26, 2015",No Escape,5000000,27288872,42844516,37844516,756.89032,22288872,445.77744,tt1781922,25,NZ,en
4273,74,"Aug 26, 2015",No Escape,5000000,27288872,42844516,37844516,756.89032,22288872,445.77744,tt1781922,2,CA,en
4277,78,"Aug 26, 2011",Our Idiot Brother,5000000,24814830,25861249,20861249,417.22498,19814830,396.2966,tt1637706,22,XWW,en
4277,78,"Aug 26, 2011",Our Idiot Brother,5000000,24814830,25861249,20861249,417.22498,19814830,396.2966,tt1637706,6,US,en
4282,83,"Jul 5, 2013",The Way Way Back,5000000,21502690,26853810,21853810,437.07620000000003,16502690,330.0538,tt1727388,8,XWW,en
4285,86,"Dec 17, 1997",The Apostle,5000000,20733485,21277770,16277770,325.5554,15733485,314.66970000000003,tt1331294,2,XWW,en
4302,3,"Mar 15, 2013",Spring Breakers,5000000,14124286,31149251,26149251,522.98502,9124286,182.48572000000001,tt2101441,20,IL,he
4328,29,"Sep 21, 2018",Fahrenheit 11/9,5000000,6352306,6653715,1653715,33.0743,1352306,27.046120000000002,tt8632862,10,IL,he
4328,29,"Sep 21, 2018",Fahrenheit 11/9,5000000,6352306,6653715,1653715,33.0743,1352306,27.046120000000002,tt8632862,2,CA,fr
4344,45,"Mar 3, 2017",Table 19,5000000,3614896,4620399,-379601,-7.59202,-1385104,-27.702080000000002,tt1412528,13,CA,fr
4351,52,"Dec 17, 2010",Rabbit Hole,5000000,2229058,6205034,1205034,24.10068,-2770942,-55.41884,tt0935075,17,BE,fr
4353,54,"Dec 28, 2016",Paterson,5000000,2141423,10727536,5727536,114.55072,-2858577,-57.17154,tt5247022,15,CA,fr
4353,54,"Dec 28, 2016",Paterson,5000000,2141423,10727536,5727536,114.55072,-2858577,-57.17154,tt5247022,1,IL,he
4375,76,"May 30, 2008",Stuck,5000000,67505,67505,-4932495,-98.6499,-4932495,-98.6499,tt9164964,2,XWW,en
4379,80,"Aug 14, 2009",Grace,5000000,8297,8297,-4991703,-99.83406000000001,-4991703,-99.83406000000001,tt5365036,4,XWW,en
4380,81,"May 15, 2015",Area 51,5000000,7556,7556,-4992444,-99.84888,-4992444,-99.84888,tt1900817,6,XWW,en
4400,1,"Jan 23, 2015",Mommy,4900000,3498695,17536004,12636004,257.87763265306126,-1401305,-28.598061224489797,tt3612616,7,FI,sv
4400,1,"Jan 23, 2015",Mommy,4900000,3498695,17536004,12636004,257.87763265306126,-1401305,-28.598061224489797,tt3612616,9,TR,tr
4403,4,"Aug 17, 2012",The Awakening,4900000,95933,6924321,2024321,41.312673469387754,-4804067,-98.04218367346938,tt1785266,2,XWW,en
4414,15,"Mar 10, 2015",Treading Water,4700000,0,0,-4700000,-100.0,-4700000,-100.0,tt2091427,4,XWW,en
4420,21,"Jun 24, 2011",Le nom des gens,4600000,514237,9261711,4661711,101.34154347826087,-4085763,-88.8209347826087,tt1646974,4,CA,fr
4422,23,"Oct 19, 2007",Out of the Blue,4600000,728,731767,-3868233,-84.09202173913044,-4599272,-99.98417391304348,tt2751576,7,XWW,en
4430,31,"Jun 27, 1956",Moby Dick,4500000,10400000,10400000,5900000,131.11111111111111,5900000,131.11111111111111,tt1984208,5,XWW,en
4431,32,"Mar 25, 2016",The Lobster,4500000,9196278,18019834,13519834,300.44075555555554,4696278,104.36173333333333,tt3464902,12,TR,tr
4446,47,"May 8, 2015",Maggie,4500000,187112,1027760,-3472240,-77.16088888888889,-4312888,-95.84195555555556,tt1881002,10,IL,he
4463,64,"Jun 6, 2014",Anna,4357373,0,1200000,-3157373,-72.46047102233388,-4357373,-100.0,tt2617676,3,IN,te
4463,64,"Jun 6, 2014",Anna,4357373,0,1200000,-3157373,-72.46047102233388,-4357373,-100.0,tt4898888,4,XWW,en
4485,86,"Dec 15, 1960",Exodus,4000000,21750000,21750000,17750000,443.75,17750000,443.75,tt1764565,3,XWW,en
4494,95,"Aug 4, 2000",Saving Grace,4000000,12178602,27786849,23786849,594.671225,8178602,204.46505,tt2764060,1,NZ,en
4497,98,"May 13, 2016",The Darkness,4000000,10753574,10898293,6898293,172.457325,6753574,168.83935000000002,tt4935746,3,XWW,en
4501,2,"Apr 11, 2008",The Visitor,4000000,9427026,19174817,15174817,379.37042499999995,5427026,135.67565,tt5085588,2,XWW,en
4501,2,"Apr 11, 2008",The Visitor,4000000,9427026,19174817,15174817,379.37042499999995,5427026,135.67565,tt4938930,2,XWW,en
4517,18,"Aug 24, 2012",Samsara,4000000,2672413,5966671,1966671,49.166775,-1327587,-33.189675,tt0770802,6,TR,tr
4524,25,"Oct 17, 2012",Holy Motors,4000000,641054,4230426,230426,5.76065,-3358946,-83.97365,tt2076220,4,CA,fr
4529,30,"Apr 11, 2014",Joe,4000000,373375,373375,-3626625,-90.665625,-3626625,-90.665625,tt2382396,8,TR,tr
4529,30,"Apr 11, 2014",Joe,4000000,373375,373375,-3626625,-90.665625,-3626625,-90.665625,tt2382396,9,IL,he
4534,35,"Jun 7, 2019",Late Night,4000000,246305,246305,-3753695,-93.842375,-3753695,-93.842375,tt6107548,1,US,en
4534,35,"Jun 7, 2019",Late Night,4000000,246305,246305,-3753695,-93.842375,-3753695,-93.842375,tt6107548,2,XWW,en
4540,41,"Jun 19, 2015",Manglehorn,4000000,132270,797439,-3202561,-80.064025,-3867730,-96.69324999999999,tt2893490,6,IL,he
4548,49,"Dec 27, 2002",Sonny,4000000,17639,17639,-3982361,-99.559025,-3982361,-99.559025,tt1599354,4,XWW,en
4555,56,"Mar 20, 2012",A Lonely Place to Die,4000000,0,442550,-3557450,-88.93625,-4000000,-100.0,tt1422136,6,IE,en
4556,57,"Dec 31, 2003",Nothing,4000000,0,63180,-3936820,-98.4205,-4000000,-100.0,tt1844678,3,XWW,en
4561,62,"Nov 9, 2012",Replicas,4000000,0,0,-4000000,-100.0,-4000000,-100.0,tt1790869,4,XWW,en
4581,82,"May 20, 1948",The Pirate,3700000,2956000,2956000,-744000,-20.10810810810811,-744000,-20.10810810810811,tt2181959,8,XEU,en
4590,91,"Apr 13, 2018",Truth or Dare,3500000,41411015,95127344,91627344,2617.9241142857145,37911015,1083.171857142857,tt2321661,1,XWW,en
4590,91,"Apr 13, 2018",Truth or Dare,3500000,41411015,95127344,91627344,2617.9241142857145,37911015,1083.171857142857,tt5944422,2,XWW,en
4592,93,"Apr 26, 1995",Friday,3500000,27467564,27936778,24436778,698.1936571428571,23967564,684.7875428571429,tt5311004,5,XWW,en
4593,94,"Feb 19, 2016",The Witch,3500000,25138705,40454520,36954520,1055.8434285714286,21638705,618.2487142857143,tt4263482,20,GB,en
4593,94,"Feb 19, 2016",The Witch,3500000,25138705,40454520,36954520,1055.8434285714286,21638705,618.2487142857143,tt4263482,2,US,en
4593,94,"Feb 19, 2016",The Witch,3500000,25138705,40454520,36954520,1055.8434285714286,21638705,618.2487142857143,tt4263482,5,XWW,en
4601,2,"Jun 21, 1972",Frenzy,3500000,12600000,12600000,9100000,260.0,9100000,260.0,tt4895740,9,XWW,en
4614,15,"Sep 30, 2016",American Honey,3500000,663247,2611750,-888250,-25.378571428571426,-2836753,-81.05008571428571,tt3721936,5,IL,he
4622,23,"Jun 26, 2009",Surveillance,3500000,27349,1396395,-2103605,-60.102999999999994,-3472651,-99.2186,tt1298649,8,CA,fr
4626,27,"Oct 1, 2006",The Secret,3500000,0,0,-3500000,-100.0,-3500000,-100.0,tt3596332,1,XWW,en
4626,27,"Oct 1, 2006",The Secret,3500000,0,0,-3500000,-100.0,-3500000,-100.0,tt5436486,4,XWW,en
4626,27,"Oct 1, 2006",The Secret,3500000,0,0,-3500000,-100.0,-3500000,-100.0,tt5436486,5,HK,en
4629,30,"Mar 11, 2014",In the Name of the King III,3500000,0,0,-3500000,-100.0,-3500000,-100.0,tt2379386,16,CA,en
4631,32,"Jun 5, 2015",Dawn Patrol,3500000,0,0,-3500000,-100.0,-3500000,-100.0,tt2073661,2,US,en
4631,32,"Jun 5, 2015",Dawn Patrol,3500000,0,0,-3500000,-100.0,-3500000,-100.0,tt2073661,4,XWW,en
4639,40,"Jul 11, 2008",August,3400000,12636,12636,-3387364,-99.62835294117647,-3387364,-99.62835294117647,tt1753773,5,FI,sv
4639,40,"Jul 11, 2008",August,3400000,12636,12636,-3387364,-99.62835294117647,-3387364,-99.62835294117647,tt1753773,6,XWW,en
4639,40,"Jul 11, 2008",August,3400000,12636,12636,-3387364,-99.62835294117647,-3387364,-99.62835294117647,tt9073702,3,XWW,en
4642,43,"Oct 10, 2014",Whiplash,3300000,13092006,38969037,35669037,1080.879909090909,9792006,296.7274545454545,tt2582802,11,TR,tr
4642,43,"Oct 10, 2014",Whiplash,3300000,13092006,38969037,35669037,1080.879909090909,9792006,296.7274545454545,tt2582802,22,CA,fr
4642,43,"Oct 10, 2014",Whiplash,3300000,13092006,38969037,35669037,1080.879909090909,9792006,296.7274545454545,tt2582802,3,IL,he
4647,48,"Jan 20, 2015",The Opposite Sex,3300000,0,50206,-3249794,-98.47860606060605,-3300000,-100.0,tt2796678,6,XWW,en
4656,57,"Jun 3, 2011",Beginners,3200000,5790894,14314407,11114407,347.32521875,2590894,80.96543750000001,tt1532503,10,IL,he
4658,59,"Jul 29, 2009",Adam,3200000,2283291,2834485,-365515,-11.42234375,-916709,-28.64715625,tt6316466,1,XWW,en
4664,65,"Oct 20, 2010",Paranormal Activity 2,3000000,84752907,177512032,174512032,5817.067733333333,81752907,2725.0969,tt1536044,21,TR,tr
4664,65,"Oct 20, 2010",Paranormal Activity 2,3000000,84752907,177512032,174512032,5817.067733333333,81752907,2725.0969,tt1536044,9,JP,en
4671,72,"Jan 1, 1978",Coming Home,3000000,32653000,32653000,29653000,988.4333333333334,29653000,988.4333333333334,tt2194497,6,XEU,en
4671,72,"Jan 1, 1978",Coming Home,3000000,32653000,32653000,29653000,988.4333333333334,29653000,988.4333333333334,tt3125472,16,XWW,en
4677,78,"Jun 10, 1975",Love and Death,3000000,20123742,20123742,17123742,570.7914,17123742,570.7914,tt3031014,2,PH,en
4698,99,"May 24, 2013",Before Midnight,3000000,8110621,23251930,20251930,675.0643333333334,5110621,170.35403333333335,tt1611914,2,PH,en
4702,3,"Oct 27, 2017",Let There Be Light,3000000,7233471,7241309,4241309,141.37696666666665,4233471,141.1157,tt5114154,12,XWW,en
4707,8,"Apr 28, 2006",Water,3000000,5529144,11322573,8322573,277.4191,2529144,84.3048,tt2344840,1,XWW,en
4707,8,"Apr 28, 2006",Water,3000000,5529144,11322573,8322573,277.4191,2529144,84.3048,tt2390250,1,XWW,en
4709,10,"Jun 24, 2016",Swiss Army Man,3000000,4210454,5837111,2837111,94.57036666666667,1210454,40.34846666666667,tt4034354,6,NZ,en
4713,14,"May 17, 2013",Frances Ha,3000000,4067398,11262769,8262769,275.42563333333334,1067398,35.57993333333334,tt2347569,11,TR,tr
4713,14,"May 17, 2013",Frances Ha,3000000,4067398,11262769,8262769,275.42563333333334,1067398,35.57993333333334,tt2347569,12,FI,sv
4713,14,"May 17, 2013",Frances Ha,3000000,4067398,11262769,8262769,275.42563333333334,1067398,35.57993333333334,tt2347569,13,CH,de
4713,14,"May 17, 2013",Frances Ha,3000000,4067398,11262769,8262769,275.42563333333334,1067398,35.57993333333334,tt2347569,2,CH,fr
4713,14,"May 17, 2013",Frances Ha,3000000,4067398,11262769,8262769,275.42563333333334,1067398,35.57993333333334,tt2347569,7,CA,fr
4725,26,"Oct 16, 1998",Happiness,3000000,2746453,5746453,2746453,91.54843333333334,-253547,-8.451566666666666,tt5805026,2,HK,en
4725,26,"Oct 16, 1998",Happiness,3000000,2746453,5746453,2746453,91.54843333333334,-253547,-8.451566666666666,tt5805026,5,XWW,en
4727,28,"Sep 19, 2014",Tusk,3000000,1821983,1887554,-1112446,-37.08153333333333,-1178017,-39.26723333333334,tt3099498,6,CA,fr
4728,29,"May 12, 2017",The Wall,3000000,1803064,4495262,1495262,49.84206666666667,-1196936,-39.897866666666665,tt1745686,4,XEU,en
4728,29,"May 12, 2017",The Wall,3000000,1803064,4495262,1495262,49.84206666666667,-1196936,-39.897866666666665,tt1745686,5,XWW,en
4728,29,"May 12, 2017",The Wall,3000000,1803064,4495262,1495262,49.84206666666667,-1196936,-39.897866666666665,tt2503980,1,XWW,en
4728,29,"May 12, 2017",The Wall,3000000,1803064,4495262,1495262,49.84206666666667,-1196936,-39.897866666666665,tt4805936,3,XWW,en
4731,32,"Mar 25, 2005",Oldboy,3000000,707391,6239723,3239723,107.99076666666667,-2292609,-76.4203,tt1321511,16,TR,tr
4739,40,"Aug 23, 1996",Freeway,3000000,295493,295493,-2704507,-90.15023333333333,-2704507,-90.15023333333333,tt2076384,3,XWW,en
4768,69,"Sep 18, 1967",Point Blank,3000000,0,0,-3000000,-100.0,-3000000,-100.0,tt1545759,3,XWW,en
4768,69,"Sep 18, 1967",Point Blank,3000000,0,0,-3000000,-100.0,-3000000,-100.0,tt3735086,2,XWW,en
4792,93,"Oct 26, 2018",Indivisible,2700000,3511417,3588305,888305,32.90018518518519,811417,30.05248148148148,tt2104857,3,XWW,en
4792,93,"Oct 26, 2018",Indivisible,2700000,3511417,3588305,888305,32.90018518518519,811417,30.05248148148148,tt5259496,4,XWW,en
4797,98,"Jan 12, 1956",Diane,2660000,0,0,-2660000,-100.0,-2660000,-100.0,tt6705860,2,US,en
4797,98,"Jan 12, 1956",Diane,2660000,0,0,-2660000,-100.0,-2660000,-100.0,tt6705860,3,CA,fr
4802,3,"May 2, 2014",Ida,2600000,3827060,15298355,12698355,488.39826923076924,1227060,47.19461538461538,tt2718492,17,FI,sv
4802,3,"May 2, 2014",Ida,2600000,3827060,15298355,12698355,488.39826923076924,1227060,47.19461538461538,tt2718492,20,CH,de
4802,3,"May 2, 2014",Ida,2600000,3827060,15298355,12698355,488.39826923076924,1227060,47.19461538461538,tt2718492,24,IL,he
4802,3,"May 2, 2014",Ida,2600000,3827060,15298355,12698355,488.39826923076924,1227060,47.19461538461538,tt2718492,7,CH,fr
4811,12,"Jan 11, 2013",A Haunted House,2500000,40041683,59922558,57422558,2296.9023199999997,37541683,1501.66732,tt2243537,27,CA,en
4833,34,"Apr 1, 2011",Super,2500000,327716,593933,-1906067,-76.24268,-2172284,-86.89135999999999,tt1512235,4,IL,he
4840,41,"Aug 16, 2013",Underdogs,2500000,35017,1392649,-1107351,-44.29404,-2464983,-98.59932,tt1634003,14,NZ,en
4840,41,"Aug 16, 2013",Underdogs,2500000,35017,1392649,-1107351,-44.29404,-2464983,-98.59932,tt1634003,4,CA,en
4843,44,"Jun 21, 2013",Alien Uprising,2500000,0,0,-2500000,-100.0,-2500000,-100.0,tt2040578,2,GB,en
4843,44,"Jun 21, 2013",Alien Uprising,2500000,0,0,-2500000,-100.0,-2500000,-100.0,tt2040578,9,XWW,en
4865,66,"Jan 19, 2016",Eden,2300000,0,0,-2300000,-100.0,-2300000,-100.0,tt2959502,4,XWW,en
4865,66,"Jan 19, 2016",Eden,2300000,0,0,-2300000,-100.0,-2300000,-100.0,tt3090634,7,TR,tr
4865,66,"Jan 19, 2016",Eden,2300000,0,0,-2300000,-100.0,-2300000,-100.0,tt3090634,9,CA,fr
4882,83,"Dec 31, 2012",Infected,2100000,0,0,-2100000,-100.0,-2100000,-100.0,tt8382074,2,CN,cmn
4893,94,"Mar 13, 2015",It Follows,2000000,14674077,23250755,21250755,1062.5377500000002,12674077,633.70385,tt3235888,19,CA,en
4893,94,"Mar 13, 2015",It Follows,2000000,14674077,23250755,21250755,1062.5377500000002,12674077,633.70385,tt3235888,21,IE,en
4893,94,"Mar 13, 2015",It Follows,2000000,14674077,23250755,21250755,1062.5377500000002,12674077,633.70385,tt3235888,28,NZ,en
4910,11,"Oct 6, 2017",The Florida Project,2000000,5904366,11295324,9295324,464.7662,3904366,195.2183,tt5649144,5,TR,tr
4914,15,"Aug 20, 2003",Thirteen,2000000,4601043,9505996,7505996,375.2998,2601043,130.05215,tt4080028,4,XWW,en
4936,37,"Apr 25, 2014",Locke,2000000,1370646,2088390,88390,4.4195,-629354,-31.467699999999997,tt2692904,17,TR,tr
4936,37,"Apr 25, 2014",Locke,2000000,1370646,2088390,88390,4.4195,-629354,-31.467699999999997,tt2692904,3,CA,fr
4936,37,"Apr 25, 2014",Locke,2000000,1370646,2088390,88390,4.4195,-629354,-31.467699999999997,tt2692904,7,IL,he
4939,40,"Apr 8, 2011",Meek's Cutoff,2000000,977772,1869928,-130072,-6.5036,-1022228,-51.111399999999996,tt1518812,12,FI,sv
4961,62,"Oct 9, 2015",Knock Knock,2000000,36336,6328516,4328516,216.42579999999998,-1963664,-98.1832,tt3605418,8,IE,en
4961,62,"Oct 9, 2015",Knock Knock,2000000,36336,6328516,4328516,216.42579999999998,-1963664,-98.1832,tt3605418,9,CA,en
4968,69,"Aug 27, 2010",Circle,2000000,10024,10024,-1989976,-99.4988,-1989976,-99.4988,tt2825894,1,XWW,en
4978,79,"Apr 1, 2013",Stitches,2000000,0,63555,-1936445,-96.82225,-2000000,-100.0,tt7319312,2,XWW,en
4984,85,"Aug 12, 1927",Wings,2000000,0,0,-2000000,-100.0,-2000000,-100.0,tt5487524,10,XWW,en
4991,92,"Dec 31, 2014",Lucky Dog,2000000,0,0,-2000000,-100.0,-2000000,-100.0,tt2224445,1,XWW,en
5003,4,"May 8, 1987",River's Edge,1900000,4600000,4600000,2700000,142.10526315789474,2700000,142.10526315789474,tt7476946,5,XWW,en
5009,10,"Apr 9, 2010",The Square,1900000,406216,740932,-1159068,-61.00357894736842,-1493784,-78.62021052631579,tt3753108,2,XWW,en
5009,10,"Apr 9, 2010",The Square,1900000,406216,740932,-1159068,-61.00357894736842,-1493784,-78.62021052631579,tt2486682,4,GB,en
5009,10,"Apr 9, 2010",The Square,1900000,406216,740932,-1159068,-61.00357894736842,-1493784,-78.62021052631579,tt2486682,6,XWW,en
5099,100,"Oct 25, 2013",The Square,1500000,124244,176262,-1323738,-88.2492,-1375756,-91.71706666666667,tt3753108,2,XWW,en
5099,100,"Oct 25, 2013",The Square,1500000,124244,176262,-1323738,-88.2492,-1375756,-91.71706666666667,tt2486682,4,GB,en
5099,100,"Oct 25, 2013",The Square,1500000,124244,176262,-1323738,-88.2492,-1375756,-91.71706666666667,tt2486682,6,XWW,en
5012,13,"Jul 26, 2013",Stranded,1900000,0,285593,-1614407,-84.96878947368421,-1900000,-100.0,tt1372689,6,XWW,en
5036,37,"Oct 8, 2010",I Spit on Your Grave,1750000,93051,1278471,-471529,-26.944514285714288,-1656949,-94.6828,tt1242432,17,JP,en
5041,42,"Feb 28, 2014",The Lunchbox,1700000,4231500,12231500,10531500,619.5,2531500,148.91176470588235,tt2350496,16,LU,fr
5041,42,"Feb 28, 2014",The Lunchbox,1700000,4231500,12231500,10531500,619.5,2531500,148.91176470588235,tt2350496,17,IN,en
5041,42,"Feb 28, 2014",The Lunchbox,1700000,4231500,12231500,10531500,619.5,2531500,148.91176470588235,tt2350496,25,XWW,en
5046,47,"Jun 24, 2005",Yes,1700000,396035,661221,-1038779,-61.104647058823524,-1303965,-76.70382352941176,tt5797286,2,CA,fr
5059,60,"Sep 26, 2014",Two Night Stand,1600000,15600,868081,-731919,-45.7449375,-1584400,-99.02499999999999,tt2140619,18,NZ,en
5059,60,"Sep 26, 2014",Two Night Stand,1600000,15600,868081,-731919,-45.7449375,-1584400,-99.02499999999999,tt2140619,22,CA,en
5059,60,"Sep 26, 2014",Two Night Stand,1600000,15600,868081,-731919,-45.7449375,-1584400,-99.02499999999999,tt2140619,5,IE,en
5062,63,"Apr 1, 2011",Insidious,1500000,54009150,99870886,98370886,6558.059066666667,52509150,3500.6100000000006,tt1591095,29,LU,fr
5070,71,"Jul 21, 1995",Kids,1500000,7412216,20412216,18912216,1260.8144,5912216,394.14773333333335,tt1988678,3,XWW,en
5073,74,"Oct 31, 1945",Spellbound,1500000,7000000,7000000,5500000,366.66666666666663,5500000,366.66666666666663,tt2132405,3,XWW,en
5073,74,"Oct 31, 1945",Spellbound,1500000,7000000,7000000,5500000,366.66666666666663,5500000,366.66666666666663,tt2132405,5,XAS,en
5115,16,"Nov 20, 2015",#Horror,1500000,0,0,-1500000,-100.0,-1500000,-100.0,tt3526286,3,XWW,en
5115,16,"Nov 20, 2015",#Horror,1500000,0,0,-1500000,-100.0,-1500000,-100.0,tt3526286,4,US,en
5120,21,"Nov 20, 2015",Mustang,1400000,845464,5552584,4152584,296.61314285714286,-554536,-39.60971428571429,tt3966404,17,FI,sv
5120,21,"Nov 20, 2015",Mustang,1400000,845464,5552584,4152584,296.61314285714286,-554536,-39.60971428571429,tt3966404,5,CA,fr
5124,25,"Apr 5, 2013",Eddie: The Sleepwalking Cannibal,1400000,1632,1632,-1398368,-99.88342857142857,-1398368,-99.88342857142857,tt1480658,8,CA,en
5143,44,"May 24, 2011",Forget Me Not,1300000,0,13465,-1286535,-98.96423076923077,-1300000,-100.0,tt1788440,2,XWW,en
5143,44,"May 24, 2011",Forget Me Not,1300000,0,13465,-1286535,-98.96423076923077,-1300000,-100.0,tt2389530,2,XWW,en
5143,44,"May 24, 2011",Forget Me Not,1300000,0,13465,-1286535,-98.96423076923077,-1300000,-100.0,tt4192636,1,XWW,en
5182,83,"Aug 28, 2012",Below Zero,1200000,0,0,-1200000,-100.0,-1200000,-100.0,tt1641388,5,XWW,en
5182,83,"Aug 28, 2012",Below Zero,1200000,0,0,-1200000,-100.0,-1200000,-100.0,tt1641388,6,CA,en
5202,3,"Mar 7, 2017",Departure,1100000,0,27561,-1072439,-97.49445454545454,-1100000,-100.0,tt7964104,2,XEU,en
5213,14,"Apr 17, 2015",Unfriended,1000000,32789645,64364198,63364198,6336.419800000001,31789645,3178.9645,tt3713166,17,SG,en
5213,14,"Apr 17, 2015",Unfriended,1000000,32789645,64364198,63364198,6336.419800000001,31789645,3178.9645,tt3713166,1,US,en
5213,14,"Apr 17, 2015",Unfriended,1000000,32789645,64364198,63364198,6336.419800000001,31789645,3178.9645,tt3713166,2,CA,en
5213,14,"Apr 17, 2015",Unfriended,1000000,32789645,64364198,63364198,6336.419800000001,31789645,3178.9645,tt3713166,32,PH,en
5224,25,"Dec 29, 2010",Blue Valentine,1000000,9737892,16566240,15566240,1556.624,8737892,873.7892,tt1120985,13,IL,he
5224,25,"Dec 29, 2010",Blue Valentine,1000000,9737892,16566240,15566240,1556.624,8737892,873.7892,tt1120985,17,CA,en
5224,25,"Dec 29, 2010",Blue Valentine,1000000,9737892,16566240,15566240,1556.624,8737892,873.7892,tt1120985,22,IE,en
5224,25,"Dec 29, 2010",Blue Valentine,1000000,9737892,16566240,15566240,1556.624,8737892,873.7892,tt1120985,25,JP,en
5241,42,"Oct 21, 2011",Martha Marcy May Marlene,1000000,2981038,5438911,4438911,443.8911,1981038,198.1038,tt1441326,16,CA,fr
5251,52,"Dec 7, 2001",No Man's Land,1000000,1067481,2684207,1684207,168.4207,67481,6.7481,tt2617208,6,XEU,en
5251,52,"Dec 7, 2001",No Man's Land,1000000,1067481,2684207,1684207,168.4207,67481,6.7481,tt1456660,7,XWW,en
5252,53,"Oct 9, 1998",Slam,1000000,1009819,1087521,87521,8.7521,9819,0.9819,tt4379536,8,XWW,en
5253,54,"Oct 6, 2017",Visages villages,1000000,952432,4015686,3015686,301.5686,-47568,-4.7568,tt5598102,22,CA,fr
5255,56,"Aug 18, 2017",Patti Cake$,1000000,800148,1471090,471090,47.109,-199852,-19.9852,tt6288250,2,CA,fr
5261,62,"Jul 29, 2011",The Future,1000000,568662,1239174,239174,23.9174,-431338,-43.1338,tt1992156,5,XWW,en
5261,62,"Jul 29, 2011",The Future,1000000,568662,1239174,239174,23.9174,-431338,-43.1338,tt4120176,14,XEU,en
5269,70,"Jul 18, 2014",I Origins,1000000,336472,852399,-147601,-14.760100000000001,-663528,-66.3528,tt2884206,4,CA,fr
5288,89,"Sep 22, 2000",The Specials,1000000,12996,12996,-987004,-98.7004,-987004,-98.7004,tt8655470,3,XWW,en
5305,6,"Oct 24, 2003",The Party's Over,1000000,0,0,-1000000,-100.0,-1000000,-100.0,tt6173020,5,XWW,en
5313,14,"Jan 7, 2014",Hidden Away,1000000,0,0,-1000000,-100.0,-1000000,-100.0,tt3289362,5,XWW,en
5321,22,"Apr 8, 2016",Hush,1000000,0,0,-1000000,-100.0,-1000000,-100.0,tt2077772,2,XWW,en
5321,22,"Apr 8, 2016",Hush,1000000,0,0,-1000000,-100.0,-1000000,-100.0,tt1480670,1,XWW,en
5392,93,"Aug 4, 2017",Columbus,700000,1017107,1110511,410511,58.64442857142858,317107,45.301,tt5990474,7,TR,tr
5392,93,"Aug 4, 2017",Columbus,700000,1017107,1110511,410511,58.64442857142858,317107,45.301,tt5990474,9,CA,en
5395,96,"Mar 13, 2015",Walter,700000,0,0,-700000,-100.0,-700000,-100.0,tt2334964,1,XWW,en
5401,2,"Dec 31, 2012",After,650000,0,0,-650000,-100.0,-650000,-100.0,tt4126476,16,TR,tr
5419,20,"Feb 24, 2015",Irreplaceable,600000,0,0,-600000,-100.0,-600000,-100.0,tt5078326,5,XWW,en
5430,31,"Aug 6, 2004",Open Water,500000,30500882,55518641,55018641,11003.728200000001,30000882,6000.1764,tt1320291,13,JP,en
5446,47,"Jul 12, 2002",Never Again,500000,307631,308793,-191207,-38.2414,-192369,-38.473800000000004,tt3659188,1,CA,en
5446,47,"Jul 12, 2002",Never Again,500000,307631,308793,-191207,-38.2414,-192369,-38.473800000000004,tt8976472,2,XWW,en
5449,50,"Oct 29, 2010",Monsters,500000,237301,5639730,5139730,1027.946,-262699,-52.5398,tt5253186,2,XWW,en
5454,55,"Apr 1, 2011",Rubber,500000,100370,680914,180914,36.1828,-399630,-79.926,tt1612774,14,BE,fr
5464,65,"Sep 10, 2014",Born to Fly: Elizabeth Streb vs. Gravity,500000,1822,1822,-498178,-99.6356,-498178,-99.6356,tt2246526,2,US,en
5464,65,"Sep 10, 2014",Born to Fly: Elizabeth Streb vs. Gravity,500000,1822,1822,-498178,-99.6356,-498178,-99.6356,tt2246526,3,XWW,en
5471,72,"Dec 31, 2010",Drones,500000,0,0,-500000,-100.0,-500000,-100.0,tt3297330,3,CA,fr
5495,96,"Aug 22, 1997",Sunday,450000,410919,450349,349,0.07755555555555556,-39081,-8.684666666666667,tt10256894,2,XWW,en
5497,98,"Nov 20, 2015",Siakh lokhamim: ha'slilim ha'gnouzim,450000,41260,42503,-407497,-90.55488888888888,-408740,-90.83111111111111,tt3457376,3,IL,he
5516,17,"Jul 27, 2001",Jackpot,400000,44452,44452,-355548,-88.887,-355548,-88.887,tt1809231,4,XWW,en
5516,17,"Jul 27, 2001",Jackpot,400000,44452,44452,-355548,-88.887,-355548,-88.887,tt4320966,2,XWW,en
5558,59,"Oct 31, 2014",All You Need Is Love,300000,0,3565259,3265259,1088.4196666666667,-300000,-100.0,tt1854236,18,XWW,en
5558,59,"Oct 31, 2014",All You Need Is Love,300000,0,3565259,3265259,1088.4196666666667,-300000,-100.0,tt4971480,3,XWW,en
5567,68,"Aug 17, 2012",Compliance,270000,319285,830700,560700,207.66666666666666,49285,18.253703703703703,tt1971352,12,JP,en
5567,68,"Aug 17, 2012",Compliance,270000,319285,830700,560700,207.66666666666666,49285,18.253703703703703,tt1971352,17,CA,en
5573,74,"Oct 28, 2011",Like Crazy,250000,3395391,3728400,3478400,1391.3600000000001,3145391,1258.1564,tt4621872,9,XWW,en
5578,79,"Mar 28, 1997",Love and Other Catastrophes,250000,212285,743216,493216,197.2864,-37715,-15.085999999999999,tt5822766,4,XWW,en
5588,89,"Jun 6, 2014",Test,250000,18823,18823,-231177,-92.4708,-231177,-92.4708,tt4131188,5,XWW,en
5592,93,"Oct 5, 2010",Rust,250000,0,0,-250000,-100.0,-250000,-100.0,tt1833781,4,XWW,en
5597,98,"Dec 31, 2010",Butterfly,250000,0,0,-250000,-100.0,-250000,-100.0,tt3019620,8,XWW,en
5597,98,"Dec 31, 2010",Butterfly,250000,0,0,-250000,-100.0,-250000,-100.0,tt3919820,4,XWW,en
5615,16,"Oct 18, 1996",Swingers,200000,4505922,6618578,6418578,3209.2889999999998,4305922,2152.9610000000002,tt7795376,4,XWW,en
5619,20,"Feb 11, 2000",Trois,200000,1161843,1161843,961843,480.9215,961843,480.9215,tt1517177,6,BE,fr
5632,33,"Mar 14, 2014",The Word,200000,3648,3648,-196352,-98.176,-196352,-98.176,tt3509804,6,XWW,en
5642,43,"Sep 23, 2011",Weekend,190000,484592,1577585,1387585,730.3078947368422,294592,155.04842105263157,tt4183002,1,XEU,en
5685,86,"Jul 7, 2017",A Ghost Story,100000,1594798,2769782,2669782,2669.782,1494798,1494.798,tt6265828,9,CA,en
5747,48,"Jan 14, 2000",The Terrorist,25000,195043,195043,170043,680.172,170043,680.172,tt1686039,15,XWW,en
5752,53,"Aug 1, 1991",Slacker,23000,1227508,1227508,1204508,5236.991304347826,1204508,5236.991304347826,tt2806788,2,XWW,en
