,id,movie,production_budget,domestic_gross,worldwide_gross,overall_profitability,start_year,genres
0,1,Avatar,425000000,760507625,2776345279,2351345279,2011,['Horror']
1,2,Pirates of the Caribbean: On Stranger Tides,410600000,241063875,1045663875,635063875,2011,"['Action', 'Adventure', 'Fantasy']"
2,3,Dark Phoenix,350000000,42762350,149762350,-200237650,2019,"['Action', 'Adventure', 'Sci-Fi']"
3,4,Avengers: Age of Ultron,330600000,459005868,1403013963,1072413963,2015,"['Action', 'Adventure', 'Sci-Fi']"
6,7,Avengers: Infinity War,300000000,678815482,2048134200,1748134200,2018,"['Action', 'Adventure', 'Sci-Fi']"
8,9,Justice League,300000000,229024295,655945209,355945209,2017,"['Action', 'Adventure', 'Fantasy']"
9,10,Spectre,300000000,200074175,879620923,579620923,2015,"['Action', 'Adventure', 'Thriller']"
10,11,The Dark Knight Rises,275000000,448139099,1084439099,809439099,2012,"['Action', 'Thriller']"
11,12,Solo: A Star Wars Story,275000000,213767512,393151347,118151347,2018,"['Action', 'Adventure', 'Fantasy']"
12,13,The Lone Ranger,275000000,89302115,260002115,-14997885,2013,"['Action', 'Adventure', 'Western']"
13,14,John Carter,275000000,73058679,282778100,7778100,2012,"['Action', 'Adventure', 'Sci-Fi']"
14,15,Tangled,260000000,200821936,586477240,326477240,2010,"['Adventure', 'Animation', 'Comedy']"
16,17,Captain America: Civil War,250000000,408084349,1140069413,890069413,2016,"['Action', 'Adventure', 'Sci-Fi']"
17,18,Batman v Superman: Dawn of Justice,250000000,330360194,867500281,617500281,2016,"['Action', 'Adventure', 'Fantasy']"
18,19,The Hobbit: An Unexpected Journey,250000000,303003568,1017003568,767003568,2012,"['Adventure', 'Family', 'Fantasy']"
20,21,The Hobbit: The Desolation of Smaug,250000000,258366855,960366855,710366855,2013,"['Adventure', 'Fantasy']"
21,22,The Hobbit: The Battle of the Five Armies,250000000,255119788,945577621,695577621,2014,"['Adventure', 'Fantasy']"
22,23,The Fate of the Furious,250000000,225764765,1234846267,984846267,2017,"['Action', 'Crime', 'Thriller']"
24,25,Pirates of the Caribbean: Dead Men Tell No Tales,230000000,172558876,788241137,558241137,2017,"['Action', 'Adventure', 'Fantasy']"
26,27,The Avengers,225000000,623279547,1517935897,1292935897,2012,"['Action', 'Adventure', 'Sci-Fi']"
28,29,Man of Steel,225000000,291045518,667999518,442999518,2013,"['Action', 'Adventure', 'Sci-Fi']"
30,31,The Amazing Spider-Man,220000000,262030663,757890267,537890267,2012,"['Action', 'Adventure', 'Sci-Fi']"
31,32,Battleship,220000000,65233400,313477717,93477717,2012,"['Action', 'Adventure', 'Sci-Fi']"
32,33,Transformers: The Last Knight,217000000,130168683,602893340,385893340,2017,"['Action', 'Adventure', 'Sci-Fi']"
33,34,Jurassic World,215000000,652270625,1648854864,1433854864,2015,"['Action', 'Adventure', 'Sci-Fi']"
34,35,Men in Black 3,215000000,179020854,654213485,439213485,2012,"['Action', 'Adventure', 'Comedy']"
36,37,Transformers: Age of Extinction,210000000,245439076,1104039076,894039076,2014,"['Action', 'Adventure', 'Sci-Fi']"
38,39,Robin Hood,210000000,105487148,322459006,112459006,2010,"['Action', 'Adventure', 'Drama']"
39,40,King Kong,207000000,218080025,550517357,343517357,2018,"['Action', 'Adventure']"
41,42,Black Panther,200000000,700059566,1348258224,1148258224,2018,"['Action', 'Adventure', 'Sci-Fi']"
42,43,Titanic,200000000,659363944,2208208395,2008208395,2012,['Adventure']
43,44,Incredibles 2,200000000,608581744,1242520711,1042520711,2018,"['Action', 'Adventure', 'Animation']"
44,45,Rogue One: A Star Wars Story,200000000,532177324,1049102856,849102856,2016,"['Action', 'Adventure', 'Sci-Fi']"
45,46,Finding Dory,200000000,486295561,1021215193,821215193,2016,"['Adventure', 'Animation', 'Comedy']"
46,47,Toy Story 3,200000000,415004880,1068879522,868879522,2010,"['Adventure', 'Animation', 'Comedy']"
47,48,Iron Man 3,200000000,408992272,1215392272,1015392272,2013,"['Action', 'Adventure', 'Sci-Fi']"
50,51,Alice in Wonderland,200000000,334191110,1025491110,825491110,2010,"['Adventure', 'Family', 'Fantasy']"
51,52,Skyfall,200000000,304360277,1110526981,910526981,2012,"['Action', 'Adventure', 'Thriller']"
52,53,Monsters University,200000000,268488329,743588329,543588329,2013,"['Adventure', 'Animation', 'Comedy']"
53,54,Oz the Great and Powerful,200000000,234770996,490359051,290359051,2013,"['Adventure', 'Family', 'Fantasy']"
54,55,X-Men: Days of Future Past,200000000,233921534,747862775,547862775,2014,"['Action', 'Adventure', 'Sci-Fi']"
55,56,The Amazing Spider-Man 2,200000000,202853933,708996336,508996336,2014,"['Action', 'Adventure', 'Sci-Fi']"
56,57,Cars 2,200000000,191450875,560155383,360155383,2011,"['Adventure', 'Animation', 'Comedy']"
59,60,Fantastic Beasts: The Crimes of Grindelwald,200000000,159555901,652220086,452220086,2018,"['Adventure', 'Family', 'Fantasy']"
61,62,Green Lantern,200000000,116601172,219535492,19535492,2011,"['Action', 'Adventure', 'Sci-Fi']"
63,64,Transformers: Dark of the Moon,195000000,352390543,1123790543,928790543,2011,"['Action', 'Adventure', 'Sci-Fi']"
64,65,The Mummy,195000000,80101125,409953905,214953905,2017,"['Action', 'Adventure', 'Fantasy']"
65,66,Jack the Giant Slayer,195000000,65187603,197687603,2687603,2013,"['Adventure', 'Fantasy']"
66,67,Furious 7,190000000,353007020,1518722794,1328722794,2015,"['Action', 'Crime', 'Thriller']"
67,68,Star Trek Into Darkness,190000000,228778661,467381584,277381584,2013,"['Action', 'Adventure', 'Sci-Fi']"
68,69,World War Z,190000000,202359711,531514650,341514650,2013,"['Action', 'Adventure', 'Horror']"
69,70,The Great Gatsby,190000000,144840419,351040419,161040419,2013,"['Drama', 'Romance']"
71,72,Pacific Rim,190000000,101802906,411002906,221002906,2013,"['Action', 'Adventure', 'Sci-Fi']"
72,73,The Good Dinosaur,187500000,123087120,333771037,146271037,2015,"['Adventure', 'Animation', 'Comedy']"
73,74,Iron Man,186000000,318604126,585171547,399171547,2013,"['Comedy', 'Drama', 'Family']"
76,77,Brave,185000000,237282182,554606532,369606532,2012,"['Adventure', 'Animation', 'Comedy']"
77,78,Kong: Skull Island,185000000,168052812,561072059,376072059,2017,"['Action', 'Adventure', 'Fantasy']"
78,79,Star Trek Beyond,185000000,158848340,335802233,150802233,2016,"['Action', 'Adventure', 'Sci-Fi']"
79,80,Blade Runner 2049,185000000,92054159,259357408,74357408,2017,"['Drama', 'Mystery', 'Sci-Fi']"
80,81,Aladdin,182000000,246734314,619234314,437234314,2019,"['Adventure', 'Comedy', 'Family']"
81,82,Thor: Ragnarok,180000000,315058289,846980024,666980024,2017,"['Action', 'Adventure', 'Comedy']"
83,84,Maleficent,180000000,241407328,758536735,578536735,2014,"['Action', 'Adventure', 'Family']"
84,85,Fantastic Beasts and Where to Find Them,180000000,234037575,802402853,622402853,2016,"['Adventure', 'Family', 'Fantasy']"
87,88,The Legend of Tarzan,180000000,126643061,348902025,168902025,2016,"['Action', 'Adventure', 'Drama']"
88,89,Hugo,180000000,73864507,180047784,47784,2011,"['Adventure', 'Drama', 'Family']"
89,90,Valerian and the City of a Thousand Planets,180000000,40479370,215098356,35098356,2017,"['Action', 'Adventure', 'Fantasy']"
90,91,Jupiter Ascending,179000000,47482519,181982519,2982519,2015,"['Action', 'Adventure', 'Sci-Fi']"
92,93,X-Men: Apocalypse,178000000,155442489,542537546,364537546,2016,"['Action', 'Adventure', 'Sci-Fi']"
93,94,The Meg,178000000,145443742,529530715,351530715,2018,"['Action', 'Horror', 'Sci-Fi']"
94,95,Edge of Tomorrow,178000000,100206256,370541256,192541256,2014,"['Action', 'Sci-Fi']"
95,96,Captain Marvel,175000000,426525952,1123061550,948061550,2019,"['Action', 'Adventure', 'Sci-Fi']"
96,97,The Jungle Book,175000000,364001123,962854547,787854547,2014,['Animation']
97,98,Inside Out,175000000,356461711,854235992,679235992,2011,"['Crime', 'Drama']"
98,99,Spider-Man: Homecoming,175000000,334201140,880166350,705166350,2017,"['Action', 'Adventure', 'Sci-Fi']"
99,100,Suicide Squad,175000000,325100054,746059887,571059887,2016,"['Action', 'Adventure', 'Fantasy']"
101,2,Coco,175000000,209726015,798008101,623008101,2017,"['Adventure', 'Animation', 'Comedy']"
104,5,Cars 3,175000000,152901115,383541369,208541369,2017,"['Adventure', 'Animation', 'Comedy']"
110,11,King Arthur: Legend of the Sword,175000000,39175066,139630336,-35369664,2017,"['Action', 'Adventure', 'Drama']"
111,12,47 Ronin,175000000,38362475,151716815,-23283185,2013,"['Action', 'Adventure', 'Drama']"
112,13,Jurassic World: Fallen Kingdom,170000000,417719760,1305772799,1135772799,2018,"['Action', 'Adventure', 'Sci-Fi']"
113,14,Guardians of the Galaxy,170000000,333172112,770867516,600867516,2014,"['Action', 'Adventure', 'Comedy']"
114,15,Iron Man 2,170000000,312433331,621156389,451156389,2010,"['Action', 'Adventure', 'Sci-Fi']"
115,16,Captain America: The Winter Soldier,170000000,259746958,714401889,544401889,2014,"['Action', 'Adventure', 'Sci-Fi']"
116,17,Dawn of the Planet of the Apes,170000000,208545589,710644566,540644566,2014,"['Action', 'Adventure', 'Drama']"
118,19,Snow White and the Huntsman,170000000,155136755,401021746,231021746,2012,"['Action', 'Adventure', 'Drama']"
121,22,Dumbo,170000000,113883318,345004422,175004422,2019,"['Adventure', 'Family', 'Fantasy']"
122,23,Tomorrowland,170000000,93436322,206627518,36627518,2015,"['Action', 'Adventure', 'Family']"
123,24,Alita: Battle Angel,170000000,85710210,402976036,232976036,2019,"['Action', 'Adventure', 'Sci-Fi']"
124,25,Godzilla: King of the Monsters,170000000,85576941,299276941,129276941,2019,"['Action', 'Adventure', 'Fantasy']"
125,26,Alice Through the Looking Glass,170000000,77042381,276928112,106928112,2016,"['Adventure', 'Family', 'Fantasy']"
126,27,Shrek Forever After,165000000,238736787,756244673,591244673,2010,"['Adventure', 'Animation', 'Comedy']"
127,28,Doctor Strange,165000000,232641920,676404566,511404566,2016,"['Action', 'Adventure', 'Fantasy']"
128,29,Big Hero 6,165000000,222527828,652127828,487127828,2014,"['Action', 'Adventure', 'Animation']"
129,30,How to Train Your Dragon,165000000,217581232,494870992,329870992,2010,"['Action', 'Adventure', 'Animation']"
130,31,Wreck-It Ralph,165000000,189412677,496511521,331511521,2012,"['Adventure', 'Animation', 'Comedy']"
131,32,Interstellar,165000000,188017894,666379375,501379375,2014,"['Adventure', 'Drama', 'Sci-Fi']"
132,33,Independence Day: Resurgence,165000000,103144286,384169424,219169424,2016,"['Action', 'Adventure', 'Sci-Fi']"
134,35,Beauty and the Beast,160000000,504014165,1259199706,1099199706,2014,"['Drama', 'Fantasy', 'Romance']"
135,36,Aquaman,160000000,335061807,1146894640,986894640,2018,"['Action', 'Adventure', 'Fantasy']"
137,38,Inception,160000000,292576195,835524642,675524642,2010,"['Action', 'Adventure', 'Sci-Fi']"
138,39,The Hunger Games: Mockingjay - Part 2,160000000,281723902,648986787,488986787,2015,"['Action', 'Adventure', 'Sci-Fi']"
140,41,Godzilla,160000000,200676069,529076069,369076069,2014,"['Action', 'Adventure', 'Sci-Fi']"
141,42,X-Men: First Class,160000000,146408305,355408305,195408305,2011,"['Action', 'Adventure', 'Sci-Fi']"
143,44,The Sorcerer's Apprentice,160000000,63150991,217986320,57986320,2010,"['Action', 'Adventure', 'Family']"
145,46,Warcraft,160000000,47225655,425522281,265522281,2016,"['Action', 'Adventure', 'Fantasy']"
146,47,Deepwater Horizon,156000000,61433527,122603824,-33396176,2016,"['Action', 'Drama', 'History']"
147,48,The Chronicles of Narnia: The Voyage of the Dawn Treader,155000000,104386950,418186950,263186950,2010,"['Adventure', 'Family', 'Fantasy']"
149,50,Pacific Rim: Uprising,155000000,59874525,290930148,135930148,2018,"['Action', 'Adventure', 'Sci-Fi']"
151,52,War for the Planet of the Apes,152000000,146880162,489592267,337592267,2017,"['Action', 'Adventure', 'Drama']"
154,55,Wonder Woman,150000000,412563408,821133378,671133378,2017,"['Action', 'Adventure', 'Fantasy']"
155,56,Frozen,150000000,400738009,1272469910,1122469910,2010,"['Adventure', 'Drama', 'Sport']"
156,57,Zootopia,150000000,341268248,1019429616,869429616,2016,"['Adventure', 'Animation', 'Comedy']"
161,62,Moana,150000000,248757044,637517365,487517365,2016,"['Adventure', 'Animation', 'Comedy']"
165,66,Thor: The Dark World,150000000,206362140,644602516,494602516,2013,"['Action', 'Adventure', 'Fantasy']"
168,69,Dunkirk,150000000,190068280,499837368,349837368,2017,"['Action', 'Drama', 'History']"
169,70,Thor,150000000,181030624,449326618,299326618,2011,"['Action', 'Adventure', 'Fantasy']"
173,74,Kung Fu Panda 2,150000000,165249063,664837547,514837547,2011,"['Action', 'Adventure', 'Animation']"
174,75,Mad Max: Fury Road,150000000,153636354,370098020,220098020,2015,"['Action', 'Adventure', 'Sci-Fi']"
177,78,Ready Player One,150000000,137690172,579290136,429290136,2018,"['Action', 'Adventure', 'Sci-Fi']"
182,83,The Last Airbender,150000000,131772187,319713881,169713881,2010,"['Action', 'Adventure', 'Family']"
186,87,Wrath of the Titans,150000000,83670083,305270083,155270083,2012,"['Action', 'Adventure', 'Fantasy']"
187,88,Beowulf,150000000,82280579,195080579,45080579,2018,"['Action', 'Drama', 'Fantasy']"
188,89,Dark Shadows,150000000,79727149,238202668,88202668,2012,"['Comedy', 'Fantasy', 'Horror']"
189,90,White House Down,150000000,73103784,205440387,55440387,2013,"['Action', 'Drama', 'Thriller']"
190,91,The Wolfman,150000000,62189884,142634358,-7365642,2010,"['Drama', 'Fantasy', 'Horror']"
191,92,The Great Wall,150000000,45157105,334486852,184486852,2016,"['Action', 'Adventure', 'Fantasy']"
192,93,Pan,150000000,35088320,151525973,1525973,2015,"['Adventure', 'Comedy', 'Family']"
193,94,Mars Needs Moms,150000000,21392758,39549758,-110450242,2011,"['Adventure', 'Animation', 'Family']"
196,97,Madagascar 3: Europe's Most Wanted,145000000,216391482,746921271,601921271,2012,"['Adventure', 'Animation', 'Comedy']"
198,99,How to Train Your Dragon 2,145000000,177002924,614586270,469586270,2014,"['Action', 'Adventure', 'Animation']"
199,100,Tarzan,145000000,171091819,448191819,303191819,2013,"['Adventure', 'Animation', 'Drama']"
200,1,Mr. Peabody & Sherman,145000000,111506430,269806430,124806430,2014,"['Adventure', 'Animation', 'Comedy']"
201,2,Rise of the Guardians,145000000,103412758,306900902,161900902,2012,"['Action', 'Adventure', 'Animation']"
202,3,Sahara,145000000,68671925,121671925,-23328075,2017,"['Adventure', 'Animation', 'Comedy']"
203,4,Ghostbusters,144000000,128350574,229008658,85008658,2016,"['Action', 'Comedy', 'Fantasy']"
209,10,Captain America: The First Avenger,140000000,176654505,370569776,230569776,2011,"['Action', 'Adventure', 'Sci-Fi']"
210,11,Kung Fu Panda 3,140000000,143528619,517599142,377599142,2016,"['Action', 'Adventure', 'Animation']"
212,13,G.I. Joe: Retaliation,140000000,122523060,375740705,235740705,2013,"['Action', 'Adventure', 'Sci-Fi']"
215,16,Exodus: Gods and Kings,140000000,65014513,268314513,128314513,2014,"['Action', 'Adventure', 'Drama']"
216,17,The BFG,140000000,55483770,199646680,59646680,2016,"['Adventure', 'Family', 'Fantasy']"
217,18,Gods of Egypt,140000000,31153464,138836756,-1163244,2016,"['Action', 'Adventure', 'Fantasy']"
220,21,Stealth,138000000,32116746,76416746,-61583254,2012,"['Action', 'Comedy']"
225,26,The Croods,135000000,187168425,573068425,438068425,2013,"['Action', 'Adventure', 'Animation']"
226,27,The Revenant,135000000,183637894,532938302,397938302,2015,"['Action', 'Adventure', 'Biography']"
228,29,Rango,135000000,123477607,245724600,110724600,2011,"['Adventure', 'Animation', 'Comedy']"
230,31,Turbo,135000000,83028130,286896578,151896578,2013,"['Adventure', 'Animation', 'Comedy']"
231,32,Teenage Mutant Ninja Turtles: Out of the Shadows,135000000,82051601,245328374,110328374,2016,"['Action', 'Adventure', 'Comedy']"
232,33,Happy Feet Two,135000000,64006466,157956466,22956466,2011,"['Adventure', 'Animation', 'Comedy']"
234,35,The Nutcracker and the Four Realms,132900000,54858851,170293899,37393899,2018,"['Adventure', 'Family', 'Fantasy']"
235,36,War of the Worlds,132000000,234280354,606836535,474836535,2013,['Sci-Fi']
236,37,Penguins of Madagascar,132000000,83350911,366942531,234942531,2014,"['Adventure', 'Animation', 'Comedy']"
237,38,The Hunger Games: Catching Fire,130000000,424668047,864868047,734868047,2013,"['Action', 'Adventure', 'Sci-Fi']"
240,41,Ant-Man and the Wasp,130000000,216648740,623144660,493144660,2018,"['Action', 'Adventure', 'Comedy']"
242,43,Ant-Man,130000000,180202163,518858449,388858449,2015,"['Action', 'Adventure', 'Comedy']"
243,44,Home,130000000,177397510,385997896,255997896,2011,['Drama']
244,45,Mary Poppins Returns,130000000,171958438,341528518,211528518,2018,"['Comedy', 'Family', 'Fantasy']"
245,46,Puss in Boots,130000000,149260504,554987477,424987477,2011,"['Action', 'Adventure', 'Animation']"
246,47,Megamind,130000000,148415853,321887208,191887208,2010,"['Action', 'Animation', 'Comedy']"
248,49,Rio 2,130000000,131538435,492846291,362846291,2014,"['Adventure', 'Animation', 'Comedy']"
249,50,Salt,130000000,118311368,290650494,160650494,2010,"['Action', 'Mystery', 'Thriller']"
250,51,Noah,130000000,101200044,352831065,222831065,2012,['Animation']
251,52,The Adventures of Tintin,130000000,77591831,373993951,243993951,2011,"['Action', 'Adventure', 'Animation']"
252,53,After Earth,130000000,60522097,251499665,121499665,2013,"['Action', 'Adventure', 'Drama']"
254,55,R.I.P.D.,130000000,33618855,79076678,-50923322,2013,"['Action', 'Adventure', 'Comedy']"
255,56,How to Train Your Dragon: The Hidden World,129000000,160791800,519258283,390258283,2019,"['Action', 'Adventure', 'Animation']"
257,58,Dinosaur,127500000,137748063,356148063,228648063,2011,['Animation']
258,59,Logan,127000000,226277068,615461394,488461394,2010,"['Comedy', 'Drama', 'Family']"
259,60,Night at the Museum: Secret of the Tomb,127000000,113746621,353756621,226756621,2014,"['Adventure', 'Comedy', 'Family']"
261,62,The Hunger Games: Mockingjay - Part 1,125000000,337135885,766575131,641575131,2014,"['Action', 'Adventure', 'Sci-Fi']"
266,67,Fast Five,125000000,210031325,630163454,505163454,2011,"['Action', 'Crime', 'Thriller']"
267,68,Teenage Mutant Ninja Turtles,125000000,191204754,485004754,360004754,2014,"['Action', 'Adventure', 'Comedy']"
268,69,Sherlock Holmes: A Game of Shadows,125000000,186848418,535663443,410663443,2011,"['Action', 'Adventure', 'Crime']"
270,71,The Boss Baby,125000000,175003033,510878762,385878762,2017,"['Adventure', 'Animation', 'Comedy']"
271,72,Clash of the Titans,125000000,163214888,493214888,368214888,2010,"['Action', 'Adventure', 'Fantasy']"
272,73,Trolls,125000000,153707064,344150134,219150134,2016,"['Adventure', 'Animation', 'Comedy']"
274,75,Prometheus,125000000,126477084,402448265,277448265,2012,"['Adventure', 'Mystery', 'Sci-Fi']"
275,76,The Bourne Legacy,125000000,113203870,280355920,155355920,2012,"['Action', 'Adventure', 'Thriller']"
277,78,Skyscraper,125000000,68420120,304115534,179115534,2018,"['Action', 'Adventure', 'Thriller']"
278,79,Total Recall,125000000,58877969,211856088,86856088,2012,"['Action', 'Adventure', 'Mystery']"
280,81,Monster Trucks,125000000,33370166,61642798,-63357202,2016,"['Action', 'Adventure', 'Comedy']"
285,86,Jason Bourne,120000000,162192920,416168316,296168316,2016,"['Action', 'Thriller']"
287,88,Life of Pi,120000000,124987022,620912003,500912003,2012,"['Adventure', 'Drama', 'Fantasy']"
289,90,Rampage,120000000,101028233,428056280,308056280,2018,"['Action', 'Adventure', 'Sci-Fi']"
291,92,Elysium,120000000,93050117,286192091,166192091,2013,"['Action', 'Drama', 'Sci-Fi']"
292,93,Oblivion,120000000,89107235,287916633,167916633,2013,"['Action', 'Adventure', 'Sci-Fi']"
293,94,Power Rangers,120000000,85364450,142531552,22531552,2017,"['Action', 'Adventure', 'Sci-Fi']"
295,96,RoboCop,120000000,58607007,242981799,122981799,2014,"['Action', 'Crime', 'Sci-Fi']"
297,98,Fantastic Four,120000000,56117548,167849187,47849187,2015,"['Action', 'Adventure', 'Drama']"
299,100,The Island,120000000,35818913,163018913,43018913,2011,"['Drama', 'Romance']"
301,2,Knight and Day,117000000,76423035,258751370,141751370,2010,"['Action', 'Adventure', 'Comedy']"
302,3,Venom,116000000,213511408,853628605,737628605,2018,"['Action', 'Sci-Fi', 'Thriller']"
307,8,The Wolverine,115000000,132556852,416456852,301456852,2013,"['Action', 'Adventure', 'Sci-Fi']"
312,13,Gulliver's Travels,112000000,42779261,232017848,120017848,2010,"['Adventure', 'Comedy', 'Family']"
313,14,Ferdinand,111000000,84410380,289847930,178847930,2017,"['Adventure', 'Animation', 'Comedy']"
314,15,Deadpool 2,110000000,324591735,786680557,676680557,2018,"['Action', 'Adventure', 'Comedy']"
315,16,Gravity,110000000,274092705,693698673,583698673,2013,"['Drama', 'Sci-Fi', 'Thriller']"
318,19,San Andreas,110000000,155190832,456258539,346258539,2015,"['Action', 'Adventure', 'Drama']"
319,20,The Smurfs,110000000,142614158,563749323,453749323,2011,"['Adventure', 'Animation', 'Comedy']"
324,25,The Patriot,110000000,113330342,215300000,105300000,2017,['Documentary']
325,26,300: Rise of an Empire,110000000,106580051,330780051,220780051,2014,"['Action', 'Fantasy', 'War']"
327,28,Passengers,110000000,100014699,302239672,192239672,2016,"['Drama', 'Romance', 'Sci-Fi']"
328,29,The Green Hornet,110000000,98780042,229155503,119155503,2011,"['Action', 'Comedy', 'Crime']"
330,31,Real Steel,110000000,85463309,263880341,153880341,2011,"['Action', 'Drama', 'Family']"
331,32,The A-Team,110000000,77222099,177241171,67241171,2010,"['Action', 'Adventure', 'Thriller']"
332,33,The Smurfs 2,110000000,71017784,348547523,238547523,2013,"['Adventure', 'Animation', 'Comedy']"
335,36,Ender's Game,110000000,61737191,127983283,17983283,2013,"['Action', 'Adventure', 'Fantasy']"
339,40,Ghost in the Shell,110000000,40563557,167910690,57910690,2017,"['Action', 'Drama', 'Sci-Fi']"
341,42,Men in Black: International,110000000,3100000,3100000,-106900000,2019,"['Action', 'Adventure', 'Comedy']"
344,45,Ali,109000000,58183966,87683966,-21316034,2012,['Drama']
345,46,The Martian,108000000,228433663,655271443,547271443,2015,"['Adventure', 'Drama', 'Sci-Fi']"
346,47,Allied,106000000,40098064,119266661,13266661,2016,"['Action', 'Drama', 'Romance']"
351,52,Ice Age: Collision Course,105000000,64063008,402156682,297156682,2016,"['Adventure', 'Animation', 'Comedy']"
353,54,Kingsman: The Golden Circle,104000000,100234838,408803696,304803696,2017,"['Action', 'Adventure', 'Comedy']"
355,56,Gladiator,103000000,187683805,457683805,354683805,2014,"['Documentary', 'Thriller']"
357,58,A Wrinkle in Time,103000000,100478608,133401882,30401882,2018,"['Adventure', 'Family', 'Fantasy']"
361,62,Bumblebee,102000000,127195589,465195589,363195589,2018,"['Action', 'Adventure', 'Sci-Fi']"
362,63,Cloud Atlas,102000000,27108272,130673154,28673154,2012,"['Action', 'Drama', 'Mystery']"
368,69,Django Unchained,100000000,162805434,449948323,349948323,2012,"['Drama', 'Western']"
369,70,Little Fockers,100000000,148438600,310650574,210650574,2010,"['Comedy', 'Romance']"
373,74,The Other Guys,100000000,119219978,170936470,70936470,2010,"['Action', 'Comedy', 'Crime']"
375,76,The Wolf of Wall Street,100000000,116900694,389870414,289870414,2013,"['Biography', 'Crime', 'Drama']"
376,77,Epic,100000000,107518682,262794441,162794441,2013,"['Adventure', 'Animation', 'Family']"
380,81,The Expendables 2,100000000,85028192,311979256,211979256,2012,"['Action', 'Adventure', 'Thriller']"
383,84,Hercules,100000000,72688614,243388614,143388614,2014,"['Action', 'Adventure', 'Fantasy']"
384,85,The Tourist,100000000,67631157,278731369,178731369,2010,"['Action', 'Adventure', 'Thriller']"
385,86,End of Days,100000000,66889043,212026975,112026975,2017,"['Comedy', 'Documentary', 'Drama']"
389,90,Legend of the Guardians: The Owls of Ga'Hoole,100000000,55675313,139716717,39716717,2010,"['Action', 'Adventure', 'Animation']"
393,94,Wonder Park,100000000,45216793,115149422,15149422,2019,"['Adventure', 'Animation', 'Comedy']"
395,96,The Expendables 3,100000000,39322544,209461378,109461378,2014,"['Action', 'Adventure', 'Thriller']"
397,98,Green Zone,100000000,35497337,97523020,-2476980,2010,"['Action', 'Drama', 'Thriller']"
398,99,Geostorm,100000000,33700160,220796009,120796009,2017,"['Action', 'Sci-Fi', 'Thriller']"
399,100,Point Break,100000000,28782481,126704591,26704591,2015,"['Action', 'Crime', 'Sport']"
400,1,In the Heart of the Sea,100000000,25020758,89693309,-10306691,2015,"['Action', 'Adventure', 'Biography']"
401,2,Transcendence,100000000,23022309,103039258,3039258,2012,['Drama']
403,4,Mortal Engines,100000000,15951040,85287417,-14712583,2018,"['Action', 'Adventure', 'Fantasy']"
406,7,The Peanuts Movie,99000000,130178411,250091610,151091610,2015,"['Adventure', 'Animation', 'Comedy']"
411,12,Alien: Covenant,97000000,74262031,238521247,141521247,2017,"['Horror', 'Sci-Fi', 'Thriller']"
412,13,Cinderella,95000000,201151353,534551353,439551353,2018,['Musical']
412,13,Cinderella,95000000,201151353,534551353,439551353,2021,"['Comedy', 'Fantasy']"
413,14,Ice Age: Continental Drift,95000000,161321843,879765137,784765137,2012,"['Adventure', 'Animation', 'Comedy']"
414,15,Black Hawk Down,95000000,108638745,159691085,64691085,2014,['Documentary']
415,16,Sex and the City 2,95000000,95347692,294680778,199680778,2010,"['Comedy', 'Drama', 'Romance']"
416,17,Percy Jackson & the Olympians: The Lightning Thief,95000000,88768303,223050874,128050874,2010,"['Adventure', 'Family', 'Fantasy']"
417,18,The Campaign,95000000,86907746,104907746,9907746,2012,['Comedy']
418,19,Unstoppable,95000000,81562942,165720921,70720921,2010,"['Action', 'Thriller']"
422,23,Ben-Hur,95000000,26410477,91669648,-3330352,2016,"['Action', 'Adventure', 'Drama']"
423,24,Seventh Son,95000000,17725785,108874967,13874967,2014,"['Action', 'Adventure', 'Fantasy']"
428,29,Kingsman: The Secret Service,94000000,128261724,404561724,310561724,2014,"['Action', 'Adventure', 'Comedy']"
430,31,Rise of the Planet of the Apes,93000000,176760185,470986200,377986200,2011,"['Action', 'Drama', 'Sci-Fi']"
433,34,A Good Day to Die Hard,92000000,67349198,304249198,212249198,2013,"['Action', 'Thriller']"
436,37,The Secret Life of Walter Mitty,91000000,58236838,187861183,96861183,2013,"['Adventure', 'Comedy', 'Drama']"
437,38,Jumanji: Welcome to the Jungle,90000000,404508916,964496193,874496193,2017,"['Action', 'Adventure', 'Comedy']"
441,42,Sherlock Holmes,90000000,209028679,498438212,408438212,2011,['Adventure']
444,45,What Lies Beneath,90000000,155464351,288693989,198693989,2018,"['Drama', 'Mystery', 'Thriller']"
445,46,Rio,90000000,143619809,487519809,397519809,2011,"['Adventure', 'Animation', 'Comedy']"
447,48,Charlie's Angels,90000000,125305545,259736090,169736090,2019,"['Action', 'Adventure', 'Comedy']"
448,49,Mulan,90000000,120620254,303500000,213500000,2020,"['Adventure', 'Drama', 'Family']"
450,51,The Girl with the Dragon Tattoo,90000000,102515793,239373970,149373970,2011,"['Crime', 'Drama', 'Mystery']"
451,52,Contact,90000000,100920329,165900000,75900000,2010,"['Documentary', 'History']"
454,55,The Magnificent Seven,90000000,93432655,162525156,72525156,2016,"['Action', 'Adventure', 'Western']"
455,56,Alvin and the Chipmunks: The Road Chip,90000000,85886987,249517956,159517956,2015,"['Adventure', 'Animation', 'Comedy']"
458,59,Pixels,90000000,78765986,244041804,154041804,2010,"['Action', 'Comedy']"
462,63,The Interpreter,90000000,72708161,162753837,72753837,2018,"['Comedy', 'Drama']"
463,64,Percy Jackson: Sea of Monsters,90000000,68559554,200859554,110859554,2013,"['Adventure', 'Family', 'Fantasy']"
465,66,Now You See Me 2,90000000,65075540,328325007,238325007,2016,"['Action', 'Adventure', 'Comedy']"
467,68,The Saint,90000000,61363304,169400000,79400000,2016,['Drama']
469,70,Tomb Raider,90000000,58250803,273477501,183477501,2018,"['Action', 'Adventure', 'Fantasy']"
472,73,Volcano,90000000,47546796,120100000,30100000,2011,['Drama']
475,76,Conan the Barbarian,90000000,21295021,63356133,-26643867,2011,"['Action', 'Adventure', 'Fantasy']"
476,77,The Three Musketeers,90000000,20377913,139877913,49877913,2011,"['Action', 'Adventure', 'Romance']"
477,78,The Promise,90000000,8224288,10551417,-79448583,2017,['Drama']
478,79,The Nutcracker in 3D,90000000,195459,20466016,-69533984,2010,"['Action', 'Family', 'Fantasy']"
479,80,Bright,90000000,0,0,-90000000,2017,"['Action', 'Crime', 'Fantasy']"
483,84,The Predator,88000000,51024708,159487563,71487563,2018,"['Action', 'Adventure', 'Sci-Fi']"
487,88,Cast Away,85000000,233632142,427230516,342230516,2017,"['Adventure', 'Drama']"
494,95,Divergent,85000000,150947895,276014965,191014965,2014,"['Action', 'Adventure', 'Mystery']"
495,96,Hotel Transylvania,85000000,148313048,378505812,293505812,2012,"['Animation', 'Comedy', 'Family']"
496,97,Shazam!,85000000,139606856,362899733,277899733,2019,"['Action', 'Adventure', 'Comedy']"
498,99,Safe House,85000000,126181630,208542162,123542162,2019,['Action']
504,5,Tower Heist,85000000,78046570,150422946,65422946,2011,"['Action', 'Comedy', 'Crime']"
506,7,Mirror Mirror,85000000,64935167,173613482,88613482,2012,"['Adventure', 'Comedy', 'Drama']"
507,8,The Holiday,85000000,63280000,205190324,120190324,2010,['Drama']
512,13,The Rundown,85000000,47641743,80831893,-4168107,2013,['Action']
513,14,Arthur Christmas,85000000,46462469,149717124,64717124,2011,"['Adventure', 'Animation', 'Comedy']"
514,15,xXx: Return of Xander Cage,85000000,44898413,345033359,260033359,2017,"['Action', 'Adventure', 'Thriller']"
516,17,Cats & Dogs: The Revenge of Kitty Galore,85000000,43585753,113026383,28026383,2010,"['Action', 'Comedy', 'Family']"
518,19,Showtime,85000000,37948765,78948765,-6051235,2010,"['Drama', 'Fantasy', 'Musical']"
523,24,Father's Day,85000000,28681080,35681080,-49318920,2020,['Action']
524,25,The Greatest Showman,84000000,174340174,386665550,302665550,2017,"['Biography', 'Drama', 'Musical']"
527,28,RED 2,84000000,53262560,141507355,57507355,2013,"['Action', 'Comedy', 'Crime']"
528,29,Click,82500000,137355633,237685089,155185089,2010,"['Drama', 'Horror', 'Mystery']"
530,31,Jumper,82500000,80172128,222640812,140140812,2013,"['Biography', 'Documentary', 'Drama']"
533,34,The Expendables,82000000,103068524,268268174,186268174,2010,"['Action', 'Adventure', 'Thriller']"
535,36,Call of the Wild,82000000,0,0,-82000000,2020,"['Adventure', 'Animation', 'Family']"
537,38,The Hunger Games,80000000,408010692,677923379,597923379,2012,"['Action', 'Adventure', 'Sci-Fi']"
538,39,The Hangover Part II,80000000,254464305,586464305,506464305,2011,"['Comedy', 'Mystery']"
540,41,The Lego Batman Movie,80000000,175750384,310660018,230660018,2017,"['Action', 'Animation', 'Comedy']"
541,42,Hotel Transylvania 2,80000000,169700110,469500298,389500298,2015,"['Animation', 'Comedy', 'Family']"
547,48,Grown Ups 2,80000000,133668525,247023808,167023808,2013,['Comedy']
548,49,Alvin and the Chipmunks: Chipwrecked,80000000,133107389,349088523,269088523,2011,"['Adventure', 'Animation', 'Comedy']"
551,52,Shutter Island,80000000,128012934,299461782,219461782,2010,"['Mystery', 'Thriller']"
561,62,Yogi Bear,80000000,100246011,204774690,124774690,2010,"['Adventure', 'Animation', 'Comedy']"
563,64,The Book of Eli,80000000,94835059,158750817,78750817,2010,"['Action', 'Adventure', 'Drama']"
567,68,Fury,80000000,85817906,210315681,130315681,2014,"['Action', 'Drama', 'War']"
568,69,Smallfoot,80000000,83240103,213691277,133691277,2018,"['Adventure', 'Animation', 'Comedy']"
570,71,Zookeeper,80000000,80360866,170805525,90805525,2011,"['Comedy', 'Family', 'Romance']"
572,73,Conspiracy Theory,80000000,76118990,142783718,62783718,2016,"['Horror', 'Thriller']"
580,81,The Secret Life of Pets 2,80000000,63795655,113351496,33351496,2019,"['Adventure', 'Animation', 'Comedy']"
588,89,Evolution,80000000,38311134,98341932,18341932,2015,"['Drama', 'Mystery', 'Sci-Fi']"
591,92,The Wild,80000000,37384046,99010667,19010667,2019,['Documentary']
594,95,Daylight,80000000,32908290,158908290,78908290,2010,"['Crime', 'Horror', 'Thriller']"
595,96,The Last Witch Hunter,80000000,27367660,130818912,50818912,2015,"['Action', 'Adventure', 'Fantasy']"
596,97,Pompeii,80000000,23169033,108469033,28469033,2014,"['Action', 'Adventure', 'Drama']"
599,100,Nine,80000000,19676965,53508858,-26491142,2016,['Horror']
600,1,Timeline,80000000,19480739,26703184,-53296816,2014,['Romance']
608,9,The Lion King,79300000,421785283,986214868,906914868,2019,"['Adventure', 'Animation', 'Drama']"
609,10,Journey 2: The Mysterious Island,79000000,103860290,318146162,239146162,2012,"['Action', 'Adventure', 'Comedy']"
610,11,Jack and Jill,79000000,74158157,150519217,71519217,2011,['Comedy']
612,13,Cloudy with a Chance of Meatballs 2,78000000,119793567,274392649,196392649,2013,"['Adventure', 'Animation', 'Comedy']"
618,19,The Little Prince,77500000,1311213,102028919,24528919,2019,['Action']
620,21,The Equalizer 2,77000000,102084362,190453132,113453132,2018,"['Action', 'Crime', 'Thriller']"
621,22,Despicable Me 2,76000000,368065385,975216835,899216835,2013,"['Adventure', 'Animation', 'Comedy']"
625,26,The Secret Life of Pets,75000000,368384330,886750534,811750534,2016,"['Adventure', 'Animation', 'Comedy']"
628,29,Sing,75000000,270329045,634454789,559454789,2016,"['Animation', 'Comedy', 'Family']"
629,30,Despicable Me 3,75000000,264624300,1034727750,959727750,2017,"['Adventure', 'Animation', 'Comedy']"
633,34,Grown Ups,75000000,162001186,272223430,197223430,2010,['Comedy']
636,37,Wanted,75000000,134508551,342416460,267416460,2010,['Action']
637,38,The Rock,75000000,134069511,336069511,261069511,2016,['Comedy']
640,41,Now You See Me,75000000,117723989,342769200,267769200,2013,"['Crime', 'Mystery', 'Thriller']"
642,43,Christopher Robin,75000000,99215042,197504758,122504758,2018,"['Adventure', 'Animation', 'Comedy']"
644,45,Immortals,75000000,83504017,211562435,136562435,2011,"['Action', 'Drama', 'Fantasy']"
650,51,Life,75000000,64062587,73521587,-1478413,2010,['Documentary']
653,54,Killers,75000000,47059963,95572749,20572749,2010,"['Action', 'Comedy', 'Romance']"
658,59,Bandits,75000000,41523271,71523271,-3476729,2018,['Drama']
661,62,Sucker Punch,75000000,36392502,89758389,14758389,2011,"['Action', 'Adventure', 'Fantasy']"
662,63,Hostage,75000000,34636443,77636443,2636443,2012,['Thriller']
663,64,Inferno,75000000,34343574,219519367,144519367,2018,['Documentary']
667,68,Soldier,75000000,14623082,14623082,-60376918,2010,['Drama']
668,69,Virus,75000000,14010690,30626690,-44373310,2010,"['Documentary', 'Family']"
672,73,Minions,74000000,336045770,1160336173,1086336173,2015,"['Adventure', 'Animation', 'Comedy']"
673,74,The SpongeBob Movie: Sponge Out of Water,74000000,162994032,311013181,237013181,2015,"['Adventure', 'Animation', 'Comedy']"
674,75,Unbreakable,73243106,94999143,248099143,174856037,2014,"['Adventure', 'Biography', 'Documentary']"
676,77,The Angry Birds Movie,73000000,107509366,352327887,279327887,2016,"['Action', 'Animation', 'Comedy']"
677,78,Snake Eyes,73000000,55591409,103891409,30891409,2020,"['Action', 'Adventure']"
686,87,Driven,72000000,32616869,54616869,-17383131,2014,"['Documentary', 'Family']"
699,100,Ransom,70000000,136492681,308700000,238700000,2018,"['Drama', 'Thriller']"
708,9,Olympus Has Fallen,70000000,98927592,172878928,102878928,2013,"['Action', 'Thriller']"
711,12,War Horse,70000000,79883359,156815529,86815529,2011,"['Drama', 'History', 'War']"
713,14,The Monuments Men,70000000,78031620,158702748,88702748,2014,"['Comedy', 'Drama', 'History']"
714,15,Storks,70000000,72679278,183353431,113353431,2016,"['Adventure', 'Animation', 'Comedy']"
716,17,Big Fish,70000000,66432867,123954323,53954323,2012,['Action']
717,18,Wolf,70000000,65011757,131011757,61011757,2010,"['Action', 'Crime', 'Drama']"
719,20,The Lego Ninjago Movie,70000000,59281555,122737201,52737201,2017,"['Action', 'Adventure', 'Animation']"
720,21,Dracula Untold,70000000,55991880,220241723,150241723,2014,"['Action', 'Drama', 'Fantasy']"
721,22,The Guardian,70000000,55011732,94973540,24973540,2011,['Drama']
724,25,The Dilemma,70000000,48475290,70546865,546865,2011,"['Comedy', 'Drama']"
726,27,The Siege,70000000,40934175,116625798,46625798,2011,['Documentary']
728,29,Rock of Ages,70000000,38518613,61031932,-8968068,2012,"['Comedy', 'Drama', 'Musical']"
733,34,Bad Company,70000000,30157016,69157016,-842984,2010,['Thriller']
735,36,The Finest Hours,70000000,27569558,49252761,-20747239,2016,"['Action', 'Drama', 'History']"
736,37,Escape Plan,70000000,25135965,103735965,33735965,2013,"['Action', 'Crime', 'Mystery']"
737,38,Killer Elite,70000000,25124986,65409046,-4590954,2011,"['Action', 'Crime', 'Thriller']"
741,42,The Legend of Hercules,70000000,18848538,58953319,-11046681,2014,"['Action', 'Adventure', 'Fantasy']"
742,43,Next,70000000,18211013,73591500,3591500,2019,['Horror']
746,47,Blackhat,70000000,8005980,19665004,-50334996,2015,"['Action', 'Crime', 'Thriller']"
749,50,Despicable Me,69000000,251513985,543464573,474464573,2010,"['Animation', 'Comedy', 'Family']"
750,51,Dinner for Schmucks,69000000,73026337,86796502,17796502,2010,['Comedy']
751,52,Red Sparrow,69000000,46874505,145951861,76951861,2018,"['Action', 'Drama', 'Thriller']"
752,53,The Twilight Saga: Eclipse,68000000,300531751,706102828,638102828,2010,"['Adventure', 'Drama', 'Fantasy']"
754,55,Ted 2,68000000,81476385,217214143,149214143,2015,['Comedy']
756,57,Hall Pass,68000000,45060734,87173475,19173475,2011,"['Comedy', 'Romance']"
758,59,Dreamcatcher,68000000,33685268,75685268,7685268,2015,"['Crime', 'Documentary', 'Drama']"
761,62,Downsizing,68000000,24449754,54462971,-13537029,2017,"['Drama', 'Sci-Fi']"
764,65,Abraham Lincoln: Vampire Hunter,67500000,37519139,137489730,69989730,2012,"['Action', 'Fantasy', 'Horror']"
765,66,Last Man Standing,67000000,18115927,18115927,-48884073,2010,"['Biography', 'Crime', 'Documentary']"
767,68,Entrapment,66000000,87707396,211700000,145700000,2015,['War']
769,70,Need for Speed,66000000,43568507,194169619,128169619,2014,"['Action', 'Crime', 'Thriller']"
771,72,What Women Want,65000000,182805123,374105123,309105123,2011,"['Comedy', 'Romance', 'Sci-Fi']"
772,73,Lincoln,65000000,182207973,273346281,208346281,2012,"['Biography', 'Drama', 'History']"
773,74,Ice Age,65000000,176387405,386116343,321116343,2015,"['Crime', 'Drama', 'Family']"
776,77,Hotel Transylvania 3: Summer Vacation,65000000,167500092,527079962,462079962,2018,"['Adventure', 'Animation', 'Comedy']"
781,82,Unbroken,65000000,115637895,163527824,98527824,2018,['Drama']
783,84,Due Date,65000000,100539043,211739043,146739043,2010,"['Adventure', 'Comedy']"
788,89,Annie,65000000,85911262,139829625,74829625,2014,"['Comedy', 'Drama', 'Family']"
793,94,The Kid,65000000,69688384,69688384,4688384,2010,['Drama']
795,96,The Dictator,65000000,59650222,180148897,115148897,2012,['Comedy']
797,98,This Means War,65000000,54760791,156974557,91974557,2012,"['Action', 'Comedy', 'Romance']"
798,99,Focus,65000000,53862963,168065700,103065700,2015,"['Comedy', 'Crime', 'Drama']"
800,1,Red Dawn,65000000,44806783,48164150,-16835850,2012,"['Action', 'Sci-Fi', 'Thriller']"
802,3,Everest,65000000,43482270,221297061,156297061,2015,"['Action', 'Adventure', 'Biography']"
803,4,Resident Evil: Retribution,65000000,42345531,240647629,175647629,2012,"['Action', 'Horror', 'Sci-Fi']"
810,11,The Missing,65000000,26900336,38253433,-26746567,2017,"['Action', 'Crime', 'Thriller']"
811,12,Elektra,65000000,24409722,56824633,-8175367,2010,"['Drama', 'Thriller']"
813,14,"I, Frankenstein",65000000,19075290,74575290,9575290,2014,"['Action', 'Fantasy', 'Horror']"
815,16,Sin City: A Dame to Kill For,65000000,13757804,40650842,-24349158,2014,"['Crime', 'Thriller']"
816,17,Live by Night,65000000,10378555,21774432,-43225568,2016,"['Action', 'Crime', 'Drama']"
820,21,Air Strike,65000000,0,516279,-64483721,2018,"['Action', 'Adventure', 'Drama']"
821,22,Little Man,64000000,58636047,101636047,37636047,2012,['Comedy']
826,27,Hop,63000000,108085305,188657593,125657593,2011,"['Adventure', 'Animation', 'Comedy']"
827,28,American Assassin,63000000,36249674,68310140,5310140,2017,"['Action', 'Thriller']"
832,33,The Hateful Eight,62000000,54117416,147864886,85864886,2015,"['Crime', 'Drama', 'Mystery']"
835,36,Gone Girl,61000000,167767189,368567189,307567189,2014,"['Drama', 'Mystery', 'Thriller']"
837,38,Maze Runner: The Scorch Trials,61000000,81697192,310566162,249566162,2015,"['Action', 'Sci-Fi', 'Thriller']"
838,39,2 Guns,61000000,75612460,132493015,71493015,2013,"['Action', 'Comedy', 'Crime']"
843,44,The Lego Movie,60000000,257784718,457729388,397729388,2014,"['Action', 'Adventure', 'Animation']"
849,50,Sully,60000000,125070033,238524556,178524556,2016,"['Biography', 'Drama']"
862,63,Red,60000000,90380162,196439693,136439693,2014,['Thriller']
866,67,Eat Pray Love,60000000,80574010,206598789,146598789,2010,"['Drama', 'Romance']"
867,68,Jack Reacher,60000000,80070736,217370736,157370736,2012,"['Action', 'Crime', 'Thriller']"
870,71,Contagion,60000000,75658097,137551594,77551594,2011,"['Action', 'Drama', 'Thriller']"
871,72,Any Given Sunday,60000000,75530832,100230832,40230832,2011,['Documentary']
879,80,London Has Fallen,60000000,62524260,195194085,135194085,2016,"['Action', 'Thriller']"
883,84,Hellboy,60000000,59623958,99823958,39823958,2019,"['Action', 'Adventure', 'Fantasy']"
884,85,Jack Reacher: Never Go Back,60000000,58697076,159946489,99946489,2016,"['Action', 'Thriller']"
885,86,Baywatch,60000000,58060186,175863783,115863783,2017,"['Action', 'Comedy', 'Crime']"
887,88,Joy,60000000,56451232,101134059,41134059,2010,['Drama']
888,89,ParaNorman,60000000,56003051,108119662,48119662,2012,"['Adventure', 'Animation', 'Comedy']"
893,94,The Boxtrolls,60000000,50837305,111946251,51946251,2014,"['Adventure', 'Animation', 'Comedy']"
894,95,The Dark Tower,60000000,50701325,113461527,53461527,2017,"['Action', 'Adventure', 'Fantasy']"
896,97,Jack Ryan: Shadow Recruit,60000000,50577412,131377412,71377412,2014,"['Action', 'Drama', 'Thriller']"
899,100,Vice,60000000,47836282,70883171,10883171,2015,"['Action', 'Adventure', 'Sci-Fi']"
901,2,Shooter,60000000,47003582,95538560,35538560,2019,"['Action', 'Crime', 'Drama']"
903,4,Gangster Squad,60000000,46000903,104100903,44100903,2013,"['Action', 'Crime', 'Drama']"
904,5,Smurfs: The Lost Village,60000000,45020282,197578586,137578586,2017,"['Adventure', 'Animation', 'Comedy']"
905,6,First Man,60000000,44936545,105203825,45203825,2018,"['Biography', 'Drama', 'History']"
907,8,Edge of Darkness,60000000,43313890,82812456,22812456,2010,"['Crime', 'Drama', 'Mystery']"
911,12,Duplicity,60000000,40572825,81079566,21079566,2011,['Thriller']
914,15,State of Play,60000000,37017955,88832210,28832210,2013,"['Documentary', 'Drama', 'Sport']"
917,18,Trouble with the Curve,60000000,35763137,47818913,-12181087,2012,"['Drama', 'Sport']"
921,22,Almost Famous,60000000,32522352,47371191,-12628809,2017,"['Comedy', 'Drama', 'Family']"
922,23,Cold Pursuit,60000000,32138862,62599159,2599159,2019,"['Action', 'Crime', 'Drama']"
925,26,The Mortal Instruments: City of Bones,60000000,31165421,75965567,15965567,2013,"['Action', 'Fantasy', 'Horror']"
927,28,Dragonfly,60000000,30063805,30063805,-29936195,2015,"['Crime', 'Drama', 'Thriller']"
928,29,Priest,60000000,29136626,84154026,24154026,2011,"['Action', 'Adventure', 'Fantasy']"
940,41,Supernova,60000000,14218868,14816494,-45183506,2020,['Drama']
946,47,Rock Dog,60000000,9420546,24148488,-35851512,2016,"['Adventure', 'Animation', 'Comedy']"
947,48,Mortdecai,60000000,7696134,30396134,-29603866,2015,"['Action', 'Comedy', 'Crime']"
949,50,Beyond Borders,60000000,4426297,11427090,-48572910,2016,['Documentary']
951,52,The Ridiculous 6,60000000,0,0,-60000000,2015,"['Comedy', 'Western']"
952,53,Midway,59500000,0,0,-59500000,2013,"['Documentary', 'Family']"
953,54,Sherlock Gnomes,59000000,43242871,87527651,28527651,2018,"['Adventure', 'Animation', 'Comedy']"
954,55,The Kid Who Would Be King,59000000,16790790,28348446,-30651554,2019,"['Action', 'Adventure', 'Family']"
955,56,Deadpool,58000000,363070709,801025593,743025593,2016,"['Action', 'Adventure', 'Comedy']"
956,57,American Sniper,58000000,350126372,547326372,489326372,2014,"['Action', 'Biography', 'Drama']"
957,58,Goosebumps,58000000,80069458,158905324,100905324,2015,"['Adventure', 'Comedy', 'Family']"
959,60,Sabrina,58000000,53458319,87100000,29100000,2018,"['Horror', 'Thriller']"
960,61,Red Tails,58000000,49876377,50365498,-7634502,2012,"['Action', 'Adventure', 'Drama']"
962,63,The Internship,58000000,44672764,93672764,35672764,2013,['Comedy']
969,70,Resident Evil: Afterlife,57500000,60128566,295874190,238374190,2010,"['Action', 'Adventure', 'Horror']"
970,71,That's My Boy,57500000,36931089,58085235,585235,2012,['Comedy']
972,73,Ghost Rider: Spirit of Vengeance,57000000,51774002,149217355,92217355,2011,"['Action', 'Fantasy', 'Thriller']"
976,77,Into the Woods,56200000,128002372,213116401,156916401,2014,"['Adventure', 'Comedy', 'Drama']"
983,84,Bohemian Rhapsody,55000000,216303339,894985342,839985342,2018,"['Biography', 'Drama', 'Music']"
984,85,Hitch,55000000,177784257,366784257,311784257,2012,['Drama']
990,91,Fifty Shades Darker,55000000,114434010,381398492,326398492,2017,"['Drama', 'Romance']"
991,92,Captain Phillips,55000000,107136417,220648184,165648184,2013,"['Biography', 'Drama', 'Thriller']"
994,95,Murder on the Orient Express,55000000,102826543,345922730,290922730,2017,"['Crime', 'Drama', 'Mystery']"
995,96,The Equalizer,55000000,101530738,192903624,137903624,2014,"['Action', 'Crime', 'Thriller']"
996,97,Fifty Shades Freed,55000000,100407760,371350619,316350619,2018,"['Drama', 'Romance', 'Thriller']"
998,99,Date Night,55000000,98711404,152269033,97269033,2010,"['Comedy', 'Crime', 'Romance']"
1003,4,City of Angels,55000000,78750909,198750909,143750909,2017,"['Action', 'Drama', 'Horror']"
1004,5,Paddington,55000000,76223578,258789097,203789097,2014,"['Adventure', 'Comedy', 'Family']"
1015,16,Free Birds,55000000,55750480,110387072,55387072,2013,"['Adventure', 'Animation', 'Comedy']"
1019,20,Muppets Most Wanted,55000000,51178893,79312301,24312301,2014,"['Adventure', 'Comedy', 'Crime']"
1021,22,Kubo and the Two Strings,55000000,48023088,77548122,22548122,2016,"['Action', 'Adventure', 'Animation']"
1023,24,Burlesque,55000000,39440655,90552675,35552675,2010,"['Drama', 'Music', 'Musical']"
1026,27,The Watch,55000000,34353000,67130045,12130045,2012,"['Action', 'Comedy', 'Horror']"
1027,28,The Hunted,55000000,34234008,47213095,-7786905,2019,['Action']
1031,32,Annihilation,55000000,32732301,43070915,-11929085,2018,"['Adventure', 'Drama', 'Horror']"
1032,33,Crimson Peak,55000000,31090320,74966854,19966854,2015,"['Drama', 'Fantasy', 'Horror']"
1033,34,The Pirates! Band of Misfits,55000000,31051126,136143605,81143605,2012,"['Adventure', 'Animation', 'Comedy']"
1035,36,Chain Reaction,55000000,21226204,60209334,5209334,2017,['Drama']
1040,41,Turbulence,55000000,11532774,11532774,-43467226,2011,['Comedy']
1041,42,Bullet to the Head,55000000,9489829,22597969,-32402031,2012,"['Action', 'Crime', 'Thriller']"
1055,56,Shaft,53012938,70327868,107190108,54177170,2019,"['Action', 'Comedy', 'Crime']"
1058,59,Black Mass,53000000,62575678,98837872,45837872,2015,"['Biography', 'Crime', 'Drama']"
1059,60,Anastasia,53000000,58403409,139801096,86801096,2019,"['Adventure', 'Family', 'Fantasy']"
1060,61,Moulin Rouge,53000000,57386369,179200588,126200588,2011,['Documentary']
1064,65,Beloved,53000000,22852487,22852487,-30147513,2010,['Comedy']
1065,66,Zero Dark Thirty,52500000,95720716,134612435,82112435,2012,"['Drama', 'Thriller']"
1069,70,Valentine's Day,52000000,110485654,217569328,165569328,2010,"['Comedy', 'Romance']"
1070,71,Casino,52000000,42438300,110400000,58400000,2013,['Drama']
1071,72,The Change-Up,52000000,37243418,75997067,23997067,2011,"['Comedy', 'Fantasy']"
1078,79,Alpha,51000000,35851379,99624873,48624873,2013,['Crime']
1080,81,The Adjustment Bureau,50200000,62495645,126931325,76731325,2011,"['Romance', 'Sci-Fi', 'Thriller']"
1083,84,Ted,50000000,218665740,556016627,506016627,2012,"['Comedy', 'Fantasy']"
1084,85,22 Jump Street,50000000,191719337,331333876,281333876,2014,"['Action', 'Comedy', 'Crime']"
1090,91,Central Intelligence,50000000,127440871,217194805,167194805,2016,"['Action', 'Comedy', 'Crime']"
1091,92,Anchorman 2: The Legend Continues,50000000,127352707,172185754,122185754,2013,['Comedy']
1092,93,Super 8,50000000,127004179,257972745,207972745,2011,"['Mystery', 'Sci-Fi', 'Thriller']"
1095,96,Creed II,50000000,115715889,213591522,163591522,2018,"['Drama', 'Sport']"
1096,97,Peter Rabbit,50000000,115234093,347136477,297136477,2018,"['Adventure', 'Animation', 'Comedy']"
1099,100,The Mule,50000000,103804407,170857676,120857676,2013,"['Comedy', 'Drama']"
1101,2,Non-Stop,50000000,91742160,222383055,172383055,2014,"['Action', 'Mystery', 'Thriller']"
1106,7,The Emoji Movie,50000000,86089513,216562312,166562312,2017,"['Adventure', 'Animation', 'Comedy']"
1108,9,The Post,50000000,81903458,179748880,129748880,2017,"['Biography', 'Drama', 'History']"
1109,10,Payback,50000000,81526121,161626121,111626121,2012,['Documentary']
1113,14,We Bought a Zoo,50000000,75624550,118729073,68729073,2011,"['Comedy', 'Drama', 'Family']"
1114,15,Moneyball,50000000,75605492,111300835,61300835,2011,"['Biography', 'Drama', 'Sport']"
1118,19,Outbreak,50000000,67823573,190023573,140023573,2010,['War']
1120,21,The Forgotten,50000000,66711892,117211892,67211892,2014,['Horror']
1125,26,American Reunion,50000000,56758835,236799211,186799211,2012,['Comedy']
1126,27,Hansel & Gretel: Witch Hunters,50000000,55703475,214949716,164949716,2013,"['Action', 'Fantasy', 'Horror']"
1131,32,American Made,50000000,51342000,135569212,85569212,2017,"['Action', 'Biography', 'Comedy']"
1134,35,The Book of Life,50000000,50151543,97651543,47651543,2014,"['Adventure', 'Animation', 'Comedy']"
1137,38,The Game,50000000,48265581,80369970,30369970,2019,['Horror']
1139,40,Into the Storm,50000000,47602194,150429371,100429371,2019,['Documentary']
1140,41,The Judge,50000000,47119388,76119388,26119388,2014,"['Crime', 'Drama']"
1144,45,War Dogs,50000000,43034523,86234503,36234503,2016,"['Comedy', 'Crime', 'Drama']"
1147,48,The Peacemaker,50000000,41263140,62967368,12967368,2016,['Documentary']
1148,49,Out of Time,50000000,41083108,55489826,5489826,2011,"['Drama', 'Mystery', 'Thriller']"
1155,56,The Nice Guys,50000000,36261763,59596747,9596747,2016,"['Action', 'Comedy', 'Crime']"
1158,59,Marmaduke,50000000,33644788,89895930,39895930,2010,"['Comedy', 'Family']"
1160,61,Hereafter,50000000,32746941,108660270,58660270,2010,"['Drama', 'Fantasy', 'Romance']"
1162,63,Assassins,50000000,30306268,83306268,33306268,2014,"['Action', 'Drama', 'Thriller']"
1163,64,Zoolander 2,50000000,28848693,55348693,5348693,2016,['Comedy']
1167,68,The Host,50000000,26623701,64477051,14477051,2013,"['Action', 'Adventure', 'Drama']"
1169,70,Run All Night,50000000,26461644,66961644,16961644,2015,"['Action', 'Drama', 'Thriller']"
1177,78,Your Highness,50000000,21596445,26121638,-23878362,2011,"['Adventure', 'Comedy', 'Fantasy']"
1178,79,Snowden,50000000,21587519,35380918,-14619082,2016,"['Biography', 'Drama', 'Thriller']"
1179,80,Dream House,50000000,21302340,41642166,-8357834,2019,"['Comedy', 'Drama', 'Romance']"
1180,81,Free State of Jones,50000000,20810036,23237252,-26762748,2016,"['Action', 'Biography', 'Drama']"
1181,82,Gamer,50000000,20534907,42002029,-7997971,2011,['Drama']
1184,85,Beautiful Creatures,50000000,19452138,60282876,10282876,2013,"['Drama', 'Fantasy', 'Romance']"
1189,90,Fair Game,50000000,11497497,26097497,-23902503,2010,"['Biography', 'Drama', 'Thriller']"
1190,91,Drive Angry,50000000,10721033,41042583,-8957417,2011,"['Action', 'Fantasy', 'Thriller']"
1192,93,The Scarlet Letter,50000000,10359006,10359006,-39640994,2015,"['Drama', 'History']"
1193,94,Domino,50000000,10169202,23574057,-26425943,2019,"['Crime', 'Thriller']"
1194,95,Jade,50000000,9812870,9812870,-40187130,2013,"['Crime', 'Drama']"
1197,98,Early Man,50000000,8267544,45285890,-4714110,2018,"['Adventure', 'Animation', 'Comedy']"
1201,2,Child 44,50000000,1224330,8004221,-41995779,2015,"['Crime', 'Drama', 'History']"
1203,4,Upside Down,50000000,102118,26387039,-23612961,2012,"['Drama', 'Fantasy', 'Romance']"
1204,5,Shanghai,50000000,46425,15505922,-34494078,2010,"['Crime', 'Drama', 'Mystery']"
1207,8,The Rhythm Section,50000000,0,0,-50000000,2019,"['Action', 'Mystery', 'Thriller']"
1208,9,Ad Astra,49800000,0,0,-49800000,2019,"['Adventure', 'Drama', 'Mystery']"
1209,10,The One,49000000,43905746,72689126,23689126,2020,['Horror']
1210,11,Chappie,49000000,31569268,105002056,56002056,2015,"['Action', 'Crime', 'Drama']"
1212,13,Anna Karenina,49000000,12816367,71004627,22004627,2012,"['Drama', 'Romance']"
1215,16,Traffic,48000000,124107476,208300000,160300000,2011,"['Action', 'Adventure', 'Mystery']"
1216,17,Panic Room,48000000,95308367,196308367,148308367,2016,"['Action', 'Drama', 'Mystery']"
1217,18,Taken 3,48000000,89256424,327656424,279656424,2014,"['Action', 'Thriller']"
1219,20,Instant Family,48000000,67363237,119736188,71736188,2018,"['Comedy', 'Drama']"
1221,22,Three Kings,48000000,60652036,107752036,59752036,2010,"['Biography', 'Documentary', 'Sport']"
1222,23,Tooth Fairy,48000000,60022256,112610386,64610386,2010,"['Comedy', 'Family', 'Fantasy']"
1228,29,Out of Sight,48000000,37562568,77562568,29562568,2013,['Sport']
1230,31,Rambo,47500000,42754105,112214531,64714531,2012,"['Comedy', 'Drama', 'Thriller']"
1231,32,The Infiltrator,47500000,15436808,20718104,-26781896,2016,"['Biography', 'Crime', 'Drama']"
1233,34,Arrival,47000000,100546139,203127894,156127894,2016,"['Drama', 'Mystery', 'Sci-Fi']"
1235,36,Earth,47000000,32011576,116773317,69773317,2015,['Sci-Fi']
1239,40,Jonah Hex,47000000,10547117,11022696,-35977304,2010,"['Action', 'Drama', 'Fantasy']"
1241,42,Silence,46500000,7100177,23726626,-22773374,2016,"['Adventure', 'Drama', 'History']"
1243,44,My Best Friend's Wedding,46000000,126813153,298923419,252923419,2016,"['Comedy', 'Romance']"
1246,47,Insomnia,46000000,67263182,113622499,67622499,2015,['Drama']
1247,48,Prisoners,46000000,61002302,113402302,67402302,2013,"['Crime', 'Drama', 'Mystery']"
1253,54,Taken 2,45000000,139854287,377807404,332807404,2012,"['Action', 'Thriller']"
1257,58,Pitch Perfect 3,45000000,104897530,185736412,140736412,2017,"['Comedy', 'Music']"
1261,62,The Bucket List,45000000,93466502,174807445,129807445,2018,"['Adventure', 'Comedy']"
1262,63,The Client,45000000,92115211,117615211,72615211,2011,"['Drama', 'Thriller']"
1263,64,The Muppets,45000000,88625922,160971922,115971922,2011,"['Adventure', 'Comedy', 'Family']"
1267,68,The Girl on the Train,45000000,75395035,174278214,129278214,2013,['Thriller']
1272,73,The Bounty Hunter,45000000,67061228,135808837,90808837,2010,"['Action', 'Comedy', 'Romance']"
1278,79,Jack,45000000,58617334,58617334,13617334,2019,"['Comedy', 'Drama']"
1280,81,Office Christmas Party,45000000,54767494,91323299,46323299,2016,['Comedy']
1287,88,Savages,45000000,47323100,82513490,37513490,2012,"['Crime', 'Drama', 'Thriller']"
1289,90,Blended,45000000,46290741,127990741,82990741,2014,"['Comedy', 'Romance']"
1290,91,All Eyez on Me,45000000,44922302,54876855,9876855,2017,"['Biography', 'Drama', 'Music']"
1297,98,Dune,45000000,27447471,27447471,-17552529,2020,"['Adventure', 'Drama', 'Sci-Fi']"
1302,3,Frankenstein,45000000,22006296,112006296,67006296,2011,['Drama']
1305,6,UglyDolls,45000000,19894664,24644664,-20355336,2019,"['Adventure', 'Animation', 'Comedy']"
1306,7,The Pledge,45000000,19719930,29406132,-15593868,2011,"['Drama', 'Family']"
1309,10,Rebound,45000000,16809014,17492014,-27507986,2014,"['Horror', 'Mystery', 'Thriller']"
1310,11,The Ghost Writer,45000000,15541549,65532491,20532491,2010,"['Drama', 'Mystery', 'Thriller']"
1314,15,Dredd,45000000,13414714,41467606,-3532394,2012,"['Action', 'Crime', 'Sci-Fi']"
1315,16,The Rum Diary,45000000,13109815,21544732,-23455268,2011,"['Comedy', 'Drama']"
1317,18,Welcome to Marwen,45000000,10763520,12874922,-32125078,2018,"['Biography', 'Comedy', 'Drama']"
1318,19,Johnny English Reborn,45000000,8406711,164640401,119640401,2011,"['Action', 'Adventure', 'Comedy']"
1323,24,Pinocchio,45000000,3681811,31681811,-13318189,2021,"['Animation', 'Fantasy', 'Musical']"
1325,26,Foodfight!,45000000,0,73706,-44926294,2012,"['Action', 'Animation', 'Comedy']"
1326,27,Argo,44500000,136025503,227140757,182640757,2012,"['Biography', 'Drama', 'Thriller']"
1330,31,Charlie St. Cloud,44000000,31206263,48478084,4478084,2010,"['Drama', 'Fantasy', 'Romance']"
1331,32,The Juror,44000000,22730924,22730924,-21269076,2019,['Drama']
1332,33,The Interview,44000000,6105175,12342632,-31657368,2011,['Drama']
1333,34,Heaven's Gate,44000000,3484331,3484523,-40515477,2013,['Documentary']
1334,35,The Heat,43000000,159581587,229727774,186727774,2013,"['Action', 'Comedy', 'Crime']"
1340,41,A Monster Calls,43000000,3740823,46414530,3414530,2016,"['Animation', 'Drama', 'Fantasy']"
1341,42,The Mechanic,42500000,29121498,76347393,33847393,2011,"['Action', 'Crime', 'Thriller']"
1343,44,21 Jump Street,42000000,138447667,202812429,160812429,2012,"['Action', 'Comedy', 'Crime']"
1347,48,Boomerang,42000000,70052444,131052444,89052444,2015,"['Drama', 'Romance']"
1350,51,Snatched,42000000,45852178,57852177,15852177,2016,['Drama']
1351,52,Here Comes the Boom,42000000,45290318,73239258,31239258,2012,"['Action', 'Comedy', 'Sport']"
1354,55,Red Riding Hood,42000000,37662162,91678442,49678442,2011,"['Fantasy', 'Horror', 'Mystery']"
1357,58,Holmes & Watson,42000000,30568743,41926605,-73395,2018,"['Adventure', 'Comedy', 'Crime']"
1358,59,One for the Money,42000000,26414527,36197221,-5802779,2012,"['Action', 'Comedy', 'Crime']"
1362,63,Hero,42000000,19487173,66787173,24787173,2019,['Action']
1363,64,Man on a Ledge,42000000,18620000,49621440,7621440,2012,"['Action', 'Adventure', 'Crime']"
1364,65,The Warrior's Way,42000000,5666340,8514325,-33485675,2010,"['Action', 'Fantasy', 'Western']"
1370,71,Rocketman,41000000,57342725,108642725,67642725,2019,"['Biography', 'Drama', 'Music']"
1373,74,The Big Year,41000000,7204138,7684524,-33315476,2011,['Comedy']
1376,77,The Karate Kid,40000000,176591618,351774938,311774938,2010,"['Action', 'Drama', 'Family']"
1377,78,Fifty Shades of Grey,40000000,166167230,570998101,530998101,2015,"['Drama', 'Romance', 'Thriller']"
1378,79,The Proposal,40000000,163958031,314709717,274709717,2018,['Documentary']
1379,80,American Hustle,40000000,150117807,257878294,217878294,2013,"['Crime', 'Drama']"
1382,83,Lucy,40000000,126573960,457507776,417507776,2014,"['Action', 'Sci-Fi', 'Thriller']"
1383,84,Lone Survivor,40000000,125095601,149804632,109804632,2013,"['Action', 'Biography', 'Drama']"
1390,91,The Social Network,40000000,96962694,224922135,184922135,2010,"['Biography', 'Drama']"
1394,95,Ride Along 2,40000000,90862685,124827316,84827316,2016,"['Action', 'Comedy', 'Crime']"
1396,97,Get Hard,40000000,90411453,106511453,66511453,2015,"['Comedy', 'Crime']"
1399,100,The Accountant,40000000,86260045,152962083,112962083,2016,"['Action', 'Crime', 'Drama']"
1400,1,Dumb and Dumber To,40000000,86208010,156553592,116553592,2014,"['Adventure', 'Comedy']"
1401,2,The Other Woman,40000000,83911193,195111193,155111193,2014,"['Comedy', 'Romance']"
1405,6,The Intern,40000000,75764672,197115710,157115710,2015,"['Comedy', 'Drama']"
1407,8,Ray,40000000,75305995,124823094,84823094,2018,['Crime']
1409,10,Bridge of Spies,40000000,72313754,162498338,122498338,2015,"['Drama', 'History', 'Thriller']"
1416,17,Hacksaw Ridge,40000000,67209615,168904682,128904682,2016,"['Biography', 'Drama', 'History']"
1420,21,Unknown,40000000,63686397,136123083,96123083,2011,"['Action', 'Mystery', 'Thriller']"
1421,22,Get Him to the Greek,40000000,61153526,91455875,51455875,2010,"['Adventure', 'Comedy', 'Music']"
1424,25,The Lincoln Lawyer,40000000,58009200,87145086,47145086,2011,"['Crime', 'Drama', 'Thriller']"
1426,27,Invincible,40000000,57806952,58501127,18501127,2019,['Action']
1430,31,Horrible Bosses 2,40000000,54445357,105945357,65945357,2014,"['Comedy', 'Crime']"
1434,35,Predators,40000000,52000688,127234389,87234389,2010,"['Action', 'Adventure', 'Sci-Fi']"
1435,36,The Odd Life of Timothy Green,40000000,51853450,55249159,15249159,2012,"['Comedy', 'Drama', 'Family']"
1442,43,Jersey Boys,40000000,47047013,65282732,25282732,2014,"['Biography', 'Drama', 'Music']"
1448,49,Final Destination 5,40000000,42587643,155011165,115011165,2011,['Horror']
1449,50,Widows,40000000,42402632,73866088,33866088,2011,"['Comedy', 'Drama']"
1453,54,Sex Tape,40000000,38543473,126069509,86069509,2014,"['Comedy', 'Romance']"
1454,55,Scream 4,40000000,38180928,95989590,55989590,2011,"['Horror', 'Mystery']"
1457,58,Paul,40000000,37412945,101162106,61162106,2011,"['Adventure', 'Comedy', 'Sci-Fi']"
1458,59,The Guilt Trip,40000000,37134215,41294674,1294674,2012,"['Comedy', 'Drama']"
1459,60,Colombiana,40000000,36665854,72295262,32295262,2011,"['Action', 'Drama', 'Thriller']"
1461,62,The Commuter,40000000,36343858,101985431,61985431,2018,"['Action', 'Mystery', 'Thriller']"
1466,67,Arthur,40000000,33035397,47787943,7787943,2011,"['Comedy', 'Romance']"
1468,69,Patriots Day,40000000,31886361,52837989,12837989,2016,"['Action', 'Crime', 'Drama']"
1470,71,The Shadow,40000000,31835600,31835600,-8164400,2013,['Documentary']
1472,73,Morning Glory,40000000,31011732,59795070,19795070,2010,"['Comedy', 'Drama', 'Romance']"
1474,75,Long Shot,40000000,30202860,43711031,3711031,2019,"['Comedy', 'Romance']"
1475,76,The Art of War,40000000,30199105,30199105,-9800895,2018,['War']
1476,77,Grudge Match,40000000,29807260,69807260,29807260,2013,"['Comedy', 'Drama', 'Sport']"
1480,81,The Nut Job 2: Nutty by Nature,40000000,28370522,57438389,17438389,2017,"['Adventure', 'Animation', 'Comedy']"
1483,84,Resident Evil: The Final Chapter,40000000,26844692,314101190,274101190,2016,"['Action', 'Horror', 'Sci-Fi']"
1485,86,The House,40000000,25584504,31192425,-8807575,2011,"['Drama', 'Mystery', 'Thriller']"
1487,88,The Reaping,40000000,25126214,62226214,22226214,2014,"['Comedy', 'Horror', 'Thriller']"
1488,89,Season of the Witch,40000000,24827228,91126600,51126600,2011,"['Action', 'Adventure', 'Fantasy']"
1489,90,Renaissance Man,40000000,24172899,24172899,-15827101,2012,['Documentary']
1493,94,Mechanic: Resurrection,40000000,21218403,109738840,69738840,2016,"['Action', 'Adventure', 'Thriller']"
1498,99,Big Miracle,40000000,20157300,25268680,-14731320,2012,"['Biography', 'Drama', 'Family']"
1499,100,The Impossible,40000000,19019882,169590606,129590606,2012,"['Drama', 'History', 'Thriller']"
1500,1,A Thousand Words,40000000,18450127,20790486,-19209514,2012,"['Comedy', 'Drama']"
1503,4,Kiss of Death,40000000,14942422,14942422,-25057578,2016,"['Comedy', 'Drama']"
1514,15,The Gunman,40000000,10664749,18594227,-21405773,2015,"['Action', 'Crime', 'Drama']"
1518,19,Paranoia,40000000,7388654,16340767,-23659233,2013,"['Drama', 'Thriller']"
1520,21,Baahubali: The Beginning,40000000,6738000,26736665,-13263335,2015,"['Action', 'Drama']"
1521,22,The Hurricane Heist,40000000,6115824,30963684,-9036316,2018,"['Action', 'Adventure', 'Crime']"
1523,24,Victor Frankenstein,40000000,5775076,31124367,-8875633,2015,"['Drama', 'Horror', 'Sci-Fi']"
1526,27,Snowpiercer,40000000,4563029,88069880,48069880,2013,"['Action', 'Drama', 'Sci-Fi']"
1527,28,Sunshine,40000000,3688560,32030610,-7969390,2011,['Drama']
1530,31,Pirates,40000000,1641825,6341825,-33658175,2014,"['Action', 'Adventure', 'Comedy']"
1535,36,The Last Shot,40000000,463730,463730,-39536270,2010,['Action']
1536,37,Nomad,40000000,79123,79123,-39920877,2018,['Drama']
1538,39,Kursk,40000000,0,4212799,-35787201,2012,['Drama']
1539,40,USS Indianapolis: Men of Courage,40000000,0,1663785,-38336215,2016,"['Action', 'Drama', 'History']"
1542,43,The Goldfinch,40000000,0,0,-40000000,2019,['Drama']
1547,48,Frankenweenie,39000000,35287788,81150788,42150788,2012,"['Animation', 'Comedy', 'Family']"
1549,50,Serenity,39000000,25514517,40319440,1319440,2011,"['Biography', 'Documentary', 'Drama']"
1558,59,Captain Underpants: The First Epic Movie,38000000,73921000,126577874,88577874,2017,"['Action', 'Animation', 'Comedy']"
1559,60,Paul Blart: Mall Cop 2,38000000,71091594,107650646,69650646,2015,"['Action', 'Comedy', 'Crime']"
1561,62,Why Him?,38000000,60323786,117425156,79425156,2016,['Comedy']
1562,63,Water for Elephants,38000000,58709717,116809717,78809717,2011,"['Drama', 'Romance']"
1563,64,Life as We Know It,38000000,53374681,105887837,67887837,2010,"['Comedy', 'Drama', 'Romance']"
1565,66,Riddick,38000000,42025135,94763758,56763758,2013,"['Action', 'Adventure', 'Sci-Fi']"
1567,68,Enough,38000000,39177215,50970660,12970660,2013,"['Drama', 'History']"
1568,69,The 5th Wave,38000000,34912982,111336398,73336398,2016,"['Action', 'Adventure', 'Drama']"
1569,70,Push,38000000,31811527,49678401,11678401,2016,"['Crime', 'Thriller']"
1570,71,Rush,38000000,26947624,98230839,60230839,2013,"['Action', 'Biography', 'Drama']"
1574,75,Only the Brave,38000000,18340051,24555177,-13444823,2017,"['Action', 'Biography', 'Drama']"
1576,77,The Thing,38000000,16999934,27573078,-10426922,2011,"['Horror', 'Mystery', 'Sci-Fi']"
1577,78,Rock Star,38000000,16991902,19317765,-18682235,2015,"['Action', 'Drama', 'Romance']"
1581,82,The Sisters Brothers,38000000,3143056,13143056,-24856944,2018,"['Adventure', 'Comedy', 'Crime']"
1584,85,The Upside,37500000,108235497,119024536,81524536,2017,"['Comedy', 'Drama']"
1585,86,What to Expect When You're Expecting,37500000,41152203,88473016,50973016,2012,"['Comedy', 'Drama', 'Romance']"
1586,87,The Master,37500000,16247159,50647416,13147416,2012,['Drama']
1587,88,The Express,37500000,9793406,9813309,-27686691,2017,"['Horror', 'Thriller']"
1588,89,Twilight,37000000,192769854,402280159,365280159,2018,['Documentary']
1589,90,We're the Millers,37000000,150394119,267816276,230816276,2013,"['Comedy', 'Crime']"
1590,91,Creed,37000000,109767581,173567581,136567581,2010,['Horror']
1591,92,The Town,37000000,92186262,152566881,115566881,2010,"['Crime', 'Drama', 'Thriller']"
1592,93,Dolphin Tale,37000000,72286779,96068724,59068724,2011,"['Drama', 'Family']"
1593,94,Game Night,37000000,69179066,117378084,80378084,2012,['Comedy']
1598,99,Cop Out,37000000,44875481,55909910,18909910,2010,"['Action', 'Comedy', 'Crime']"
1599,100,The Rite,37000000,33047633,97143987,60143987,2011,"['Drama', 'Horror', 'Mystery']"
1601,2,Magnolia,37000000,22450975,48446802,11446802,2016,"['Drama', 'Family', 'Romance']"
1602,3,Aloha,37000000,21052030,25387091,-11612909,2015,"['Comedy', 'Drama', 'Romance']"
1604,5,A Star is Born,36000000,215288866,433449571,397449571,2010,"['Documentary', 'Music']"
1609,10,Hot Tub Time Machine,36000000,50269859,65967750,29967750,2010,"['Comedy', 'Sci-Fi']"
1610,11,Breakdown,36000000,50159144,50159144,14159144,2016,"['Drama', 'Thriller']"
1611,12,Dolphin Tale 2,36000000,42024533,57824533,21824533,2014,"['Drama', 'Family']"
1612,13,Collateral Beauty,36000000,31016021,85309093,49309093,2016,"['Drama', 'Romance']"
1620,21,There Be Dragons,36000000,1069334,4020990,-31979010,2011,"['Biography', 'Drama', 'War']"
1621,22,Queen of the Desert,36000000,0,1578543,-34421457,2015,"['Adventure', 'Biography', 'Drama']"
1622,23,Head of State,35200000,37788228,38283765,3083765,2016,['Comedy']
1623,24,It,35000000,327481748,697457969,662457969,2017,"['Horror', 'Thriller']"
1628,29,True Grit,35000000,171243005,252276928,217276928,2010,"['Adventure', 'Drama', 'Western']"
1630,31,Rush Hour,35000000,141186864,245300000,210300000,2018,['Documentary']
1631,32,Identity Thief,35000000,134506920,175361578,140361578,2013,"['Adventure', 'Comedy', 'Crime']"
1633,34,Horrible Bosses,35000000,117538559,212417601,177417601,2011,"['Comedy', 'Crime']"
1635,36,Trainwreck,35000000,110212700,141123897,106123897,2015,"['Comedy', 'Drama', 'Romance']"
1636,37,Saving Mr. Banks,35000000,83299761,114962525,79962525,2013,"['Biography', 'Comedy', 'Drama']"
1638,39,21,35000000,81159365,159846429,124846429,2016,['Horror']
1646,47,Sky High,35000000,63939454,83109359,48109359,2012,"['Adventure', 'Documentary', 'Drama']"
1648,49,A Nightmare on Elm Street,35000000,63075011,117729621,82729621,2010,"['Crime', 'Drama', 'Horror']"
1652,53,Secretariat,35000000,59699513,60376247,25376247,2010,"['Biography', 'Drama', 'Family']"
1654,55,Friends with Benefits,35000000,55802754,146595891,111595891,2011,"['Comedy', 'Romance']"
1655,56,Neighbors 2: Sorority Rising,35000000,55340730,108757621,73757621,2016,['Comedy']
1657,58,Radio,35000000,52333738,53293628,18293628,2013,['Thriller']
1658,59,Sicario: Day of the Soldado,35000000,50065850,75885196,40885196,2018,"['Action', 'Crime', 'Drama']"
1661,62,Poltergeist,35000000,47425125,95713069,60713069,2015,"['Horror', 'Thriller']"
1662,63,Goosebumps 2: Haunted Halloween,35000000,46697321,93291478,58291478,2018,"['Adventure', 'Comedy', 'Family']"
1663,64,12 Strong,35000000,45819713,71118378,36118378,2018,"['Action', 'Drama', 'History']"
1671,72,Something Borrowed,35000000,39046489,65084116,30084116,2011,"['Comedy', 'Drama', 'Romance']"
1673,74,In Time,35000000,37553932,165103952,130103952,2011,"['Action', 'Crime', 'Drama']"
1674,75,The Back-up Plan,35000000,37490007,75281179,40281179,2010,"['Comedy', 'Romance']"
1675,76,J. Edgar,35000000,37306030,84606030,49606030,2011,"['Biography', 'Crime', 'Drama']"
1677,78,Mile 22,35000000,36108758,66295121,31295121,2018,"['Action', 'Adventure', 'Thriller']"
1678,79,Hot Pursuit,35000000,34580201,45671512,10671512,2015,"['Action', 'Comedy', 'Crime']"
1679,80,Concussion,35000000,34531832,50363790,15363790,2013,['Drama']
1680,81,The Foreigner,35000000,34393507,140783360,105783360,2017,"['Action', 'Thriller']"
1681,82,Closer,35000000,33987757,116177695,81177695,2015,['Drama']
1688,89,Adrift,35000000,31445011,57897191,22897191,2015,['Drama']
1689,90,Mirrors,35000000,30691439,77220596,42220596,2013,['Documentary']
1690,91,Underworld: Blood Wars,35000000,30353973,81209222,46209222,2016,"['Action', 'Adventure', 'Fantasy']"
1695,96,Abduction,35000000,28087155,86648359,51648359,2011,"['Action', 'Mystery', 'Thriller']"
1699,100,Alex Cross,35000000,25888412,35426759,426759,2012,"['Action', 'Crime', 'Mystery']"
1703,4,Heist,35000000,23483357,28906817,-6093183,2015,"['Action', 'Crime', 'Thriller']"
1705,6,Whiskey Tango Foxtrot,35000000,23083334,25350747,-9649253,2016,"['Biography', 'Comedy', 'Drama']"
1707,8,Hitman: Agent 47,35000000,22467450,82182803,47182803,2015,"['Action', 'Adventure', 'Crime']"
1709,10,Premium Rush,35000000,20275446,31393201,-3606799,2012,"['Action', 'Crime', 'Thriller']"
1710,11,Broken City,35000000,19701164,34480045,-519955,2013,"['Crime', 'Drama', 'Thriller']"
1712,13,Wonder Boys,35000000,19389454,33422485,-1577515,2018,"['Crime', 'Thriller']"
1713,14,Cursed,35000000,19294901,25114901,-9885099,2017,"['Drama', 'War']"
1716,17,Furry Vengeance,35000000,17630465,39340177,4340177,2010,"['Comedy', 'Family']"
1717,18,Parker,35000000,17616641,48543388,13543388,2013,"['Action', 'Crime', 'Thriller']"
1719,20,Bait,35000000,15325127,15471969,-19528031,2012,"['Action', 'Adventure', 'Drama']"
1723,24,The Tree of Life,35000000,13305665,61721826,26721826,2011,"['Drama', 'Fantasy']"
1725,26,Zoom,35000000,11989328,12506188,-22493812,2015,"['Animation', 'Comedy', 'Drama']"
1728,29,Sabotage,35000000,10508518,18376443,-16623557,2014,"['Action', 'Crime', 'Drama']"
1731,32,Unfinished Business,35000000,10219501,13214051,-21785949,2011,"['Drama', 'Family']"
1732,33,The Walk,35000000,10161183,61492104,26492104,2015,"['Crime', 'Thriller']"
1734,35,Mandela: Long Walk to Freedom,35000000,8323085,29890402,-5109598,2013,"['Biography', 'Drama', 'History']"
1738,39,The Brothers Grimsby,35000000,6864016,28720470,-6279530,2016,"['Action', 'Adventure', 'Comedy']"
1739,40,The Snowman,35000000,6670765,43226146,8226146,2017,"['Crime', 'Drama', 'Mystery']"
1743,44,Biutiful,35000000,5101237,24687524,-10312476,2010,"['Drama', 'Romance']"
1746,47,A Hologram for the King,35000000,4212494,11846010,-23153990,2016,"['Comedy', 'Drama', 'Romance']"
1748,49,Playing for Keeps,35000000,2000000,2000000,-33000000,2012,"['Comedy', 'Romance', 'Sport']"
1752,53,Stolen,35000000,289773,17967746,-17032254,2012,"['Action', 'Crime', 'Thriller']"
1753,54,Trespass,35000000,16816,786532,-34213468,2011,"['Crime', 'Drama', 'Thriller']"
1755,56,The Lovers,35000000,0,53899,-34946101,2013,"['Action', 'Adventure', 'Romance']"
1757,58,The Darkest Hour,34800000,21443494,62831715,28031715,2011,"['Action', 'Adventure', 'Horror']"
1758,59,Baby Driver,34000000,107825862,228104185,194104185,2017,"['Action', 'Crime', 'Drama']"
1759,60,The Maze Runner,34000000,102427862,348319861,314319861,2014,"['Action', 'Mystery', 'Sci-Fi']"
1760,61,The Longest Ride,34000000,37446117,63802928,29802928,2015,"['Drama', 'Romance']"
1761,62,The Age of Innocence,34000000,32014993,32014993,-1985007,2015,['Drama']
1763,64,The Darkest Minds,34000000,12695691,38361428,4361428,2018,"['Action', 'Adventure', 'Drama']"
1767,68,Thunder and the House of Magic,34000000,4091,62582520,28582520,2013,"['Adventure', 'Animation', 'Comedy']"
1771,72,Exit Wounds,33000000,51758599,79958599,46958599,2015,"['Documentary', 'Drama', 'War']"
1772,73,Mike and Dave Need Wedding Dates,33000000,46009673,75898100,42898100,2016,"['Adventure', 'Comedy', 'Romance']"
1773,74,Step Up Revolution,33000000,35074677,165552290,132552290,2012,"['Drama', 'Music', 'Romance']"
1776,77,The Watcher,33000000,28946615,47267829,14267829,2010,['Drama']
1777,78,Safe,33000000,17142080,41495213,8495213,2012,"['Action', 'Crime', 'Thriller']"
1778,79,Doomsday,33000000,11008770,21621188,-11378812,2015,"['Action', 'Sci-Fi']"
1781,82,The Young and Prodigious T.S. Spivet,33000000,176847,357687,-32642313,2013,"['Action', 'Adventure', 'Comedy']"
1782,83,Freaks of Nature,33000000,70958,70958,-32929042,2015,"['Comedy', 'Horror', 'Sci-Fi']"
1784,85,Bridesmaids,32500000,169211718,289632023,257132023,2011,"['Comedy', 'Romance']"
1786,87,The Big Wedding,32500000,21819348,48425971,15925971,2013,"['Comedy', 'Drama', 'Romance']"
1787,88,Wanderlust,32500000,17288155,24159934,-8340066,2019,['Fantasy']
1789,90,Phenomenon,32000000,104636382,152036382,120036382,2017,['Drama']
1794,95,Takers,32000000,57744720,70587268,38587268,2010,"['Action', 'Crime', 'Thriller']"
1795,96,Source Code,32000000,54712227,140428499,108428499,2011,"['Action', 'Drama', 'Sci-Fi']"
1798,99,I Feel Pretty,32000000,48795601,91553797,59553797,2018,"['Comedy', 'Romance']"
1800,1,"Big Mommas: Like Father, Like Son",32000000,37915414,82332450,50332450,2011,"['Action', 'Comedy', 'Crime']"
1801,2,Alive,32000000,36299670,36299670,4299670,2014,['Drama']
1806,7,The Incredible Burt Wonderstone,32000000,22537881,27392609,-4607391,2013,"['Adventure', 'Comedy', 'Fantasy']"
1809,10,Bad Times at the El Royale,32000000,17839115,29204379,-2795621,2018,"['Crime', 'Drama', 'Mystery']"
1810,11,Going the Distance,32000000,17804299,43603990,11603990,2010,"['Comedy', 'Romance']"
1812,13,Repo Men,32000000,13942007,18195238,-13804762,2010,"['Action', 'Crime', 'Sci-Fi']"
1820,21,Criminal,31500000,14708696,38771262,7271262,2011,"['Action', 'Crime', 'Drama']"
1821,22,42,31000000,95020213,97470701,66470701,2013,"['Biography', 'Drama', 'Sport']"
1822,23,Flight,31000000,93772375,160558438,129558438,2012,"['Drama', 'Thriller']"
1826,27,The Grand Budapest Hotel,31000000,59076019,163981261,132981261,2014,"['Adventure', 'Comedy', 'Crime']"
1827,28,Vacation,31000000,58884188,102306500,71306500,2015,"['Adventure', 'Comedy']"
1830,31,Frequency,31000000,44983704,68079671,37079671,2012,"['Sci-Fi', 'Thriller']"
1832,33,Extraordinary Measures,31000000,12482741,15826984,-15173016,2010,['Drama']
1833,34,Birth of the Dragon,31000000,6901965,7220490,-23779510,2016,"['Action', 'Biography', 'Drama']"
1837,38,Crazy Rich Asians,30000000,174532921,238099711,208099711,2018,"['Comedy', 'Romance']"
1838,39,Chicago,30000000,170687518,306770545,276770545,2011,['Documentary']
1839,40,Big Daddy,30000000,163479795,228641283,198641283,2017,['Drama']
1841,42,The Vow,30000000,125014030,197618160,167618160,2012,"['Drama', 'Romance']"
1842,43,Speed,30000000,121248145,283200000,253200000,2015,['Drama']
1844,45,Lee Daniels' The Butler,30000000,116632095,177025498,147025498,2013,"['Biography', 'Drama']"
1848,49,The Addams Family,30000000,113502246,191502246,161502246,2019,"['Animation', 'Comedy', 'Family']"
1856,57,Sisters,30000000,87044645,106030660,76030660,2015,['Comedy']
1860,61,The Notebook,30000000,81001787,116025023,86025023,2013,"['Drama', 'War']"
1868,69,Looper,30000000,66486205,170466405,140466405,2012,"['Action', 'Crime', 'Drama']"
1869,70,Warm Bodies,30000000,66380662,115121608,85121608,2013,"['Comedy', 'Horror', 'Romance']"
1871,72,The Nut Job,30000000,64251538,122529966,92529966,2014,"['Adventure', 'Animation', 'Comedy']"
1872,73,Down to Earth,30000000,64172251,71172251,41172251,2015,"['Adventure', 'Documentary']"
1874,75,Hope Springs,30000000,63536011,133085295,103085295,2012,"['Comedy', 'Drama', 'Romance']"
1880,81,Bride Wars,30000000,58715510,115150424,85150424,2015,['Comedy']
1882,83,Midnight in Paris,30000000,56816662,162502774,132502774,2019,"['Comedy', 'Documentary', 'Drama']"
1883,84,Darkest Hour,30000000,56443120,150807172,120807172,2017,"['Biography', 'Drama', 'History']"
1887,88,Life of the Party,30000000,53059911,65759911,35759911,2017,"['Comedy', 'Drama']"
1888,89,Letters to Juliet,30000000,53032453,82148538,52148538,2010,"['Adventure', 'Comedy', 'Drama']"
1890,91,Message in a Bottle,30000000,52880016,52880016,22880016,2017,['Adventure']
1891,92,Southpaw,30000000,52421953,94156456,64156456,2015,"['Drama', 'Sport']"
1893,94,Atomic Blonde,30000000,51573925,98345423,68345423,2017,"['Action', 'Mystery', 'Thriller']"
1899,100,Sicario,30000000,46889293,84393749,54393749,2015,"['Action', 'Crime', 'Drama']"
1902,3,Den of Thieves,30000000,44947622,80131391,50131391,2018,"['Action', 'Crime', 'Drama']"
1903,4,The Three Stooges,30000000,44338224,54052249,24052249,2012,"['Comedy', 'Family']"
1905,6,John Wick,30000000,43037835,76235001,46235001,2014,"['Action', 'Crime', 'Thriller']"
1907,8,The Age of Adaline,30000000,42629776,68984536,38984536,2015,"['Drama', 'Fantasy', 'Romance']"
1908,9,Step Up 3D,30000000,42400223,165889117,135889117,2010,"['Drama', 'Music', 'Romance']"
1910,11,The Cabin in the Woods,30000000,42073277,70689968,40689968,2011,['Horror']
1913,14,Hanna,30000000,40259119,65343694,35343694,2011,"['Action', 'Drama', 'Thriller']"
1918,19,Midnight Run,30000000,38413606,81613606,51613606,2016,['Mystery']
1921,22,The Family,30000000,36918811,51078541,21078541,2011,"['Horror', 'Thriller']"
1922,23,The 15:17 to Paris,30000000,36276286,56096200,26096200,2018,"['Biography', 'Drama', 'Thriller']"
1924,25,Larry Crowne,30000000,35608245,61449135,31449135,2011,"['Comedy', 'Drama', 'Romance']"
1925,26,Carrie,30000000,35266619,82409520,52409520,2013,"['Drama', 'Horror']"
1927,28,Death Wish,30000000,34017028,48575965,18575965,2018,"['Action', 'Crime', 'Drama']"
1929,30,Entourage,30000000,32363404,46438538,16438538,2015,['Comedy']
1931,32,Side Effects,30000000,32172757,66742138,36742138,2013,"['Crime', 'Drama', 'Mystery']"
1932,33,9,30000000,31749894,48559999,18559999,2016,['Comedy']
1933,34,Deliver Us from Evil,30000000,30577122,87956618,57956618,2014,"['Horror', 'Mystery', 'Thriller']"
1934,35,Get on Up,30000000,30569935,33339868,3339868,2014,"['Biography', 'Drama', 'Music']"
1936,37,The Five-Year Engagement,30000000,28700285,61623819,31623819,2012,"['Comedy', 'Romance']"
1938,39,Winnie the Pooh,30000000,26692846,50145607,20145607,2011,"['Adventure', 'Animation', 'Comedy']"
1941,42,White Boy Rick,30000000,24004833,25947983,-4052017,2018,"['Crime', 'Drama']"
1942,43,Virtuosity,30000000,23998226,23998226,-6001774,2014,"['Biography', 'Documentary', 'Music']"
1944,45,Sanctum,30000000,23209310,108957098,78957098,2011,"['Adventure', 'Drama', 'Thriller']"
1946,47,Ballerina,30000000,21858070,96892829,66892829,2012,"['Biography', 'Documentary']"
1948,49,The Next Three Days,30000000,21148651,67255916,37255916,2010,"['Action', 'Crime', 'Drama']"
1949,50,Proud Mary,30000000,20868638,21709539,-8290461,2018,"['Action', 'Crime', 'Drama']"
1952,53,Runner Runner,30000000,19316646,60512680,30512680,2013,"['Crime', 'Thriller']"
1954,55,Baahubali 2: The Conclusion,30000000,18985794,263502914,233502914,2017,"['Action', 'Drama']"
1957,58,Fright Night,30000000,18298649,40520649,10520649,2011,"['Comedy', 'Horror']"
1959,60,Steve Jobs,30000000,17766658,35579007,5579007,2015,"['Biography', 'Drama']"
1967,68,The Cave,30000000,15007991,27147991,-2852009,2017,"['Adventure', 'Animation', 'Documentary']"
1968,69,Godsend,30000000,14334645,16910708,-13089292,2013,['Drama']
1971,72,The New World,30000000,12712093,26184400,-3815600,2011,['Documentary']
1973,74,The Last Stand,30000000,12050299,48330757,18330757,2013,"['Action', 'Thriller']"
1977,78,Dead Man Down,30000000,10895295,19599974,-10400026,2013,"['Action', 'Crime', 'Drama']"
1981,82,The Lost City of Z,30000000,8574339,17121823,-12878177,2016,"['Adventure', 'Biography', 'Drama']"
1983,84,The Space Between Us,30000000,7885294,16481405,-13518595,2017,"['Adventure', 'Drama', 'Romance']"
1985,86,Barney's Version,30000000,7502560,8845575,-21154425,2010,"['Comedy', 'Drama']"
1986,87,Trapped,30000000,6916869,6916869,-23083131,2011,['Drama']
1987,88,Kin,30000000,5718096,10096821,-19903179,2012,"['Drama', 'Music']"
1989,90,Stronger,30000000,4211129,8786752,-21213248,2017,"['Biography', 'Drama']"
1990,91,Gloria,30000000,4167493,4967493,-25032507,2013,"['Comedy', 'Drama', 'Romance']"
1992,93,The Merchant of Venice,30000000,3765585,18765585,-11234415,2015,['Drama']
1998,99,Machine Gun Preacher,30000000,538690,3721988,-26278012,2011,"['Action', 'Biography', 'Crime']"
1999,100,Bilal: A New Breed of Hero,30000000,490973,648599,-29351401,2015,"['Action', 'Adventure', 'Animation']"
2004,5,Wild Card,30000000,3200,4315789,-25684211,2015,"['Action', 'Crime', 'Drama']"
2005,6,United Passions,30000000,918,168832,-29831168,2014,"['Drama', 'History', 'Sport']"
2007,8,Grace of Monaco,30000000,0,25199891,-4800109,2014,"['Biography', 'Drama', 'Romance']"
2010,11,Space Pirate Captain Harlock,30000000,0,310985,-29689015,2010,"['Animation', 'Sci-Fi']"
2012,13,Collide,29200000,2280004,5466698,-23733302,2010,['Action']
2013,14,Pitch Perfect 2,29000000,184296230,287625468,258625468,2015,"['Comedy', 'Music']"
2015,16,Night School,29000000,77339130,103008792,74008792,2016,['Documentary']
2016,17,The Boss,29000000,63077560,78652207,49652207,2016,['Comedy']
2020,21,Logan Lucky,29000000,27778642,44264271,15264271,2017,"['Comedy', 'Crime', 'Drama']"
2021,22,Florence Foster Jenkins,29000000,27383770,56000339,27000339,2016,"['Biography', 'Comedy', 'Drama']"
2029,30,Unhinged,29000000,0,0,-29000000,2014,['Thriller']
2034,35,Straight Outta Compton,28000000,161197785,202182981,174182981,2015,"['Biography', 'Drama', 'History']"
2035,36,Girls Trip,28000000,115108515,140886353,112886353,2017,"['Comedy', 'Drama']"
2039,40,A Bad Moms Christmas,28000000,72110659,127710550,99710550,2017,"['Adventure', 'Comedy']"
2040,41,Safe Haven,28000000,71399120,94050951,66050951,2013,"['Drama', 'Romance', 'Thriller']"
2041,42,The Big Short,28000000,70259870,133162752,105162752,2015,"['Biography', 'Comedy', 'Drama']"
2042,43,Role Models,28000000,67300955,94500826,66500826,2014,['Documentary']
2043,44,"Alexander and the Terrible, Horrible, No Good, Very Bad Day",28000000,66954149,101379287,73379287,2014,"['Comedy', 'Family']"
2044,45,Miracle,28000000,64378093,64474705,36474705,2019,['Thriller']
2045,46,Last Vegas,28000000,63914167,112914167,84914167,2013,"['Comedy', 'Drama']"
2049,50,Tag,28000000,54730625,77026186,49026186,2015,['Drama']
2051,52,Identity,28000000,52131264,82183683,54183683,2015,['Drama']
2052,53,Serendipity,28000000,50255310,77477297,49477297,2018,['Drama']
2053,54,Kick-Ass,28000000,48071303,97531134,69531134,2010,"['Action', 'Comedy']"
2059,60,30 Minutes or Less,28000000,37053924,40966716,12966716,2011,"['Action', 'Comedy', 'Crime']"
2063,64,3 Days to Kill,28000000,30697999,38959900,10959900,2014,"['Action', 'Drama', 'Thriller']"
2064,65,Kick-Ass 2,28000000,28795985,63129909,35129909,2013,"['Action', 'Comedy', 'Crime']"
2066,67,A Walk Among the Tombstones,28000000,26017685,62108587,34108587,2014,"['Action', 'Crime', 'Drama']"
2067,68,The Spy Next Door,28000000,24307106,46752858,18752858,2010,"['Action', 'Comedy', 'Family']"
2068,69,Brick Mansions,28000000,20396829,73421224,45421224,2014,"['Action', 'Crime']"
2069,70,Just My Luck,28000000,17326650,38159905,10159905,2015,['Comedy']
2070,71,Lost Souls,28000000,16779636,31320293,3320293,2017,"['Action', 'Drama']"
2071,72,American Ultra,28000000,14439985,30295028,2295028,2015,"['Action', 'Comedy', 'Sci-Fi']"
2073,74,Pride and Prejudice and Zombies,28000000,10907291,16638300,-11361700,2016,"['Action', 'Comedy', 'Horror']"
2085,86,Joyful Noise,27500000,30932113,31157914,3657914,2012,"['Comedy', 'Drama', 'Music']"
2089,90,Anonymous,27500000,4463292,15815509,-11684491,2011,"['Drama', 'Thriller']"
2090,91,Limitless,27000000,79249455,155564919,128564919,2011,"['Mystery', 'Sci-Fi', 'Thriller']"
2097,98,Money Monster,27000000,41012075,93466095,66466095,2016,"['Crime', 'Drama', 'Thriller']"
2113,14,Flawless,27000000,4485485,4485485,-22514515,2018,['Drama']
2115,16,What Just Happened,27000000,1090947,2412123,-24587877,2018,['Comedy']
2117,18,The Magic Flute,27000000,0,0,-27000000,2010,['Music']
2127,28,Flatliners,26000000,61308153,61308153,35308153,2017,"['Drama', 'Horror', 'Mystery']"
2129,30,Red Eye,26000000,57891803,96666486,70666486,2017,['Horror']
2132,33,Pain & Gain,26000000,49875291,81275291,55275291,2013,"['Action', 'Comedy', 'Crime']"
2136,37,Legion,26000000,40168080,67647574,41647574,2010,"['Action', 'Fantasy', 'Horror']"
2137,38,Lawless,26000000,37397291,54393687,28393687,2012,"['Crime', 'Drama']"
2140,41,Brothers,26000000,28544157,45043870,19043870,2019,['Documentary']
2141,42,The Best of Me,26000000,26766213,41059418,15059418,2014,"['Drama', 'Romance']"
2143,44,Original Sin,26000000,16521410,16521410,-9478590,2018,['Comedy']
2144,45,The Raven,26000000,16008272,30601801,4601801,2012,"['Crime', 'Mystery', 'Thriller']"
2149,50,The Fifth Estate,26000000,3254172,6154172,-19845828,2013,"['Biography', 'Drama', 'Thriller']"
2151,52,Blood Ties,26000000,42472,2923959,-23076041,2010,['Drama']
2153,54,Viy,26000000,0,34246770,8246770,2014,"['Adventure', 'Fantasy', 'Mystery']"
2154,55,Accidental Love,26000000,0,135436,-25864564,2015,"['Comedy', 'Romance']"
2155,56,The Face of an Angel,26000000,0,0,-26000000,2014,"['Crime', 'Drama']"
2162,63,The Help,25000000,169705587,213120004,188120004,2011,['Drama']
2163,64,Hidden Figures,25000000,169607287,231771716,206771716,2016,"['Biography', 'Drama', 'History']"
2166,67,Ride Along,25000000,134202565,153733800,128733800,2014,"['Action', 'Comedy', 'Crime']"
2167,68,The Bodyguard,25000000,121945720,410899039,385899039,2018,['Drama']
2176,77,Dear John,25000000,80014842,142033509,117033509,2010,"['Drama', 'Romance', 'War']"
2178,79,Parental Guidance,25000000,77267296,120832383,95832383,2012,"['Comedy', 'Family']"
2182,83,Chocolat,25000000,71309760,152500343,127500343,2016,"['Biography', 'Drama']"
2183,84,No Strings Attached,25000000,70662220,149228078,124228078,2011,"['Comedy', 'Romance']"
2184,85,Contraband,25000000,66528000,98406855,73406855,2012,"['Action', 'Crime', 'Drama']"
2186,87,The Lucky One,25000000,60457138,96633833,71633833,2012,"['Drama', 'Romance']"
2191,92,Madea's Big Happy Family,25000000,53345287,54160818,29160818,2011,"['Comedy', 'Drama']"
2194,95,The Grey,25000000,51580136,81249176,56249176,2011,"['Action', 'Adventure', 'Drama']"
2195,96,Hide and Seek,25000000,51100486,123696741,98696741,2013,"['Action', 'Horror', 'Mystery']"
2196,97,Cobra,25000000,49042224,49042224,24042224,2019,['Drama']
2201,2,The Giver,25000000,45090374,66540205,41540205,2014,"['Drama', 'Romance', 'Sci-Fi']"
2205,6,The Night Before,25000000,43035725,52427346,27427346,2015,"['Adventure', 'Comedy', 'Fantasy']"
2208,9,Money Talks,25000000,41076865,41076865,16076865,2016,['Crime']
2214,15,August: Osage County,25000000,37738810,50738810,25738810,2013,"['Comedy', 'Drama']"
2216,17,Million Dollar Arm,25000000,36447959,39217912,14217912,2014,"['Biography', 'Drama', 'Sport']"
2220,21,Peppermint,25000000,35418723,51800758,26800758,2018,"['Action', 'Crime', 'Drama']"
2221,22,Good Luck Chuck,25000000,35017297,59183821,34183821,2016,['Comedy']
2224,25,The Gambler,25000000,33680992,38718031,13718031,2015,['Drama']
2228,29,Fist Fight,25000000,32187017,40286416,15286416,2017,['Comedy']
2231,32,The Sitter,25000000,30542576,38749404,13749404,2011,['Comedy']
2232,33,Elizabeth,25000000,30082699,82150642,57150642,2013,"['Biography', 'Documentary', 'Drama']"
2235,36,Draft Day,25000000,28842237,29847480,4847480,2014,"['Drama', 'Sport']"
2237,38,Rings,25000000,27793018,82917283,57917283,2017,"['Drama', 'Horror', 'Mystery']"
2242,43,Don't Be Afraid of the Dark,25000000,24046682,39126427,14126427,2010,"['Fantasy', 'Horror', 'Thriller']"
2243,44,The Losers,25000000,23591432,29863840,4863840,2010,"['Action', 'Adventure', 'Crime']"
2244,45,Fighting,25000000,23091010,32831707,7831707,2014,"['Action', 'Romance', 'Sport']"
2245,46,War,25000000,22486409,40686409,15686409,2014,['Drama']
2249,50,The Eagle,25000000,19490041,38993548,13993548,2011,"['Action', 'Adventure', 'Drama']"
2251,52,Shark Night 3D,25000000,18877153,18877153,-6122847,2011,"['Horror', 'Thriller']"
2255,56,Father Figures,25000000,17501244,21038441,-3961559,2017,"['Adventure', 'Comedy', 'Drama']"
2257,58,The Counselor,25000000,16973715,71009334,46009334,2013,"['Crime', 'Drama', 'Thriller']"
2259,60,Mary Queen of Scots,25000000,16468499,46734733,21734733,2013,"['Biography', 'Drama', 'History']"
2262,63,Legend,25000000,15502112,23506237,-1493763,2013,['Horror']
2265,66,The Box,25000000,15051977,34356760,9356760,2011,['Drama']
2267,68,My Soul to Take,25000000,14744435,16727470,-8272530,2010,"['Horror', 'Mystery', 'Thriller']"
2273,74,Warrior,25000000,13657115,24215385,-784615,2011,"['Drama', 'Sport']"
2275,76,Battle of the Sexes,25000000,12638526,18445379,-6554621,2017,"['Biography', 'Comedy', 'Drama']"
2276,77,Cirque du Soleil: Worlds Away,25000000,12512862,28012862,3012862,2012,['Fantasy']
2277,78,The 33,25000000,12227722,28400715,3400715,2015,"['Biography', 'Drama', 'History']"
2279,80,The Conspirator,25000000,11538204,15907411,-9092589,2010,"['Crime', 'Drama', 'History']"
2287,88,Straw Dogs,25000000,10324441,11253821,-13746179,2011,"['Action', 'Drama', 'Thriller']"
2289,90,Possession,25000000,10103647,14805812,-10194188,2012,"['Drama', 'Mystery']"
2293,94,The Road,25000000,8114270,29206732,4206732,2010,['Documentary']
2294,95,Beautiful Boy,25000000,7634767,13031424,-11968576,2018,"['Biography', 'Drama']"
2295,96,The Hoax,25000000,7164995,7164995,-17835005,2015,"['Crime', 'Documentary', 'Drama']"
2296,97,Captive State,25000000,5958315,8993300,-16006700,2019,"['Sci-Fi', 'Thriller']"
2304,5,Blindness,25000000,3073392,20052958,-4947042,2016,['Drama']
2305,6,Sgt. Stubby: An American Hero,25000000,3054285,3645957,-21354043,2018,"['Adventure', 'Animation', 'Family']"
2306,7,Carnage,25000000,2546747,38112154,13112154,2011,"['Comedy', 'Drama']"
2307,8,Tulip Fever,25000000,2455635,6792768,-18207232,2017,"['Drama', 'History', 'Romance']"
2311,12,Jane Got a Gun,25000000,1513793,3771345,-21228655,2015,"['Action', 'Drama', 'Western']"
2314,15,Where the Truth Lies,25000000,872142,1415656,-23584344,2011,['Drama']
2315,16,Without Limits,25000000,780326,780326,-24219674,2018,['Sport']
2316,17,On the Road,25000000,720828,9313302,-15686698,2012,"['Adventure', 'Drama', 'Romance']"
2318,19,Love Ranch,25000000,137885,146149,-24853851,2010,"['Biography', 'Comedy', 'Drama']"
2324,25,Ironclad,25000000,0,5297411,-19702589,2011,"['Action', 'Adventure', 'Drama']"
2325,26,The Professor and the Madman,25000000,0,5227233,-19772767,2019,"['Biography', 'Drama', 'Mystery']"
2326,27,Red Sky,25000000,0,91116,-24908884,2011,"['Drama', 'Romance']"
2328,29,The Adventurer: The Curse of the Midas Box,25000000,0,0,-25000000,2013,"['Adventure', 'Family', 'Fantasy']"
2329,30,Reagan,25000000,0,0,-25000000,2011,"['Biography', 'Documentary']"
2330,31,Dangerous Liaisons,24200000,17000,10447579,-13752421,2012,"['Drama', 'Mystery', 'Romance']"
2335,36,Think Like a Man Too,24000000,65028687,70027933,46027933,2014,"['Comedy', 'Romance']"
2336,37,Fences,24000000,57682904,64282881,40282881,2016,['Drama']
2338,39,Footloose,24000000,51802742,62989834,38989834,2011,"['Comedy', 'Drama', 'Music']"
2339,40,Going in Style,24000000,45018541,78672579,54672579,2017,"['Comedy', 'Crime']"
2343,44,Hitman,24000000,39687694,99135571,75135571,2012,['Action']
2351,52,Piranha 3D,24000000,25003155,83660160,59660160,2010,"['Comedy', 'Horror']"
2352,53,Faster,24000000,23240020,35792945,11792945,2010,"['Action', 'Crime', 'Drama']"
2357,58,I Don't Know How She Does It,24000000,9659074,24474463,474463,2011,"['Comedy', 'Romance']"
2359,60,Dhoom 3,24000000,8031955,11723620,-12276380,2013,"['Action', 'Thriller']"
2360,61,Beyond the Sea,24000000,6144806,8292914,-15707086,2010,['Documentary']
2365,66,Flood,24000000,0,4084232,-19915768,2018,['Documentary']
2370,71,Green Book,23000000,85080171,322034439,299034439,2018,"['Biography', 'Comedy', 'Drama']"
2372,73,The Wedding Ringer,23000000,64460211,80171596,57171596,2015,['Comedy']
2373,74,Final Destination,23000000,53302314,112036870,89036870,2013,['Documentary']
2375,76,The Ides of March,23000000,40962534,77735925,54735925,2011,"['Drama', 'Thriller']"
2377,78,The Hate U Give,23000000,29719483,35067665,12067665,2018,"['Crime', 'Drama']"
2379,80,Her,23000000,25568251,48163815,25163815,2013,"['Drama', 'Romance', 'Sci-Fi']"
2382,83,Haywire,23000000,18942396,36374700,13374700,2011,"['Action', 'Drama', 'Thriller']"
2383,84,Anywhere But Here,23000000,18653615,18653615,-4346385,2016,"['Drama', 'Thriller']"
2385,86,Eddie the Eagle,23000000,15789389,45060480,22060480,2015,"['Biography', 'Comedy', 'Drama']"
2387,88,The Crew,23000000,13019253,13019253,-9980747,2012,['Comedy']
2396,97,Redemption,23000000,36686,13593473,-9406527,2011,"['Adventure', 'Drama', 'Romance']"
2397,98,Rogue,23000000,10452,4673377,-18326623,2017,"['Action', 'Romance', 'Thriller']"
2402,3,Nocturnal Animals,22500000,10663357,32398681,9898681,2016,"['Drama', 'Thriller']"
2403,4,The Water Diviner,22500000,4200117,31054727,8554727,2014,"['Drama', 'History', 'War']"
2404,5,Ghost,22000000,217631306,517600000,495600000,2010,"['Drama', 'Fantasy', 'Mystery']"
2410,11,Son of God,22000000,59700064,70949793,48949793,2010,['Documentary']
2412,13,The Hundred-Foot Journey,22000000,54235441,94270488,72270488,2014,"['Comedy', 'Drama']"
2415,16,The Net,22000000,50621733,110521733,88521733,2016,['Drama']
2416,17,Diary of a Wimpy Kid: Dog Days,22000000,49008662,77229695,55229695,2012,"['Comedy', 'Family']"
2418,19,Derailed,22000000,36020063,57520063,35520063,2016,"['Action', 'Crime']"
2420,21,Delivery Man,22000000,30659817,70536870,48536870,2013,"['Comedy', 'Drama']"
2421,22,"Hail, Caesar!",22000000,30080225,64160680,42160680,2016,"['Comedy', 'Drama', 'Music']"
2424,25,Traitor,22000000,23530831,27882226,5882226,2015,"['Action', 'Drama', 'Romance']"
2426,27,Diary of a Wimpy Kid: The Long Haul,22000000,20738724,35609577,13609577,2017,"['Comedy', 'Family']"
2428,29,Homefront,22000000,20158492,51695362,29695362,2013,"['Action', 'Thriller']"
2432,33,The Glass House,22000000,17951431,22861785,861785,2014,"['Drama', 'Thriller']"
2433,34,The Transporter Refueled,22000000,16029670,69698495,47698495,2015,"['Action', 'Adventure', 'Crime']"
2436,37,Hit & Run,22000000,13749300,17216955,-4783045,2019,"['Action', 'Comedy']"
2439,40,"Roman J. Israel, Esq.",22000000,11962712,12967012,-9032988,2017,"['Crime', 'Drama', 'Thriller']"
2440,41,Out of the Furnace,22000000,11330849,15434375,-6565625,2013,"['Crime', 'Drama', 'Thriller']"
2443,44,Just Getting Started,22000000,6069605,6756412,-15243588,2017,"['Action', 'Comedy']"
2448,49,Before I Go to Sleep,22000000,3242457,19563579,-2436421,2014,"['Drama', 'Horror', 'Mystery']"
2449,50,Stone,22000000,1810078,4065020,-17934980,2010,"['Drama', 'Thriller']"
2457,58,To Rome with Love,21500000,16684352,74326015,52826015,2012,"['Comedy', 'Music', 'Romance']"
2458,59,Silver Linings Playbook,21000000,132092958,236412453,215412453,2012,"['Comedy', 'Drama', 'Romance']"
2459,60,Blockers,21000000,60311495,94045328,73045328,2018,['Comedy']
2460,61,Pet Sematary,21000000,54724696,109501146,88501146,2019,"['Horror', 'Mystery', 'Thriller']"
2463,64,Death at a Funeral,21000000,42739347,48977233,27977233,2010,['Comedy']
2466,67,For Colored Girls,21000000,37729698,38017873,17017873,2010,['Drama']
2468,69,Kidnap,21000000,30718107,34836080,13836080,2019,['Drama']
2471,72,Tinker Tailor Soldier Spy,21000000,24149393,81452811,60452811,2011,"['Drama', 'Mystery', 'Thriller']"
2473,74,The Bachelor,21000000,21731001,36882378,15882378,2016,"['Comedy', 'Romance']"
2478,79,The Beaver,21000000,970816,5046038,-15953962,2011,['Drama']
2479,80,Bitter Harvest,21000000,557241,606162,-20393838,2017,"['Drama', 'Romance', 'War']"
2480,81,Molly,21000000,17396,17396,-20982604,2017,"['Action', 'Sci-Fi']"
2481,82,Velvet Buzzsaw,21000000,0,0,-21000000,2019,"['Horror', 'Mystery', 'Thriller']"
2484,85,Pulse,20500000,20264436,30241435,9741435,2017,"['Drama', 'Fantasy', 'Sci-Fi']"
2487,88,Us,20000000,175006930,254210310,234210310,2013,['Drama']
2491,92,La La Land,20000000,151101803,426351163,406351163,2016,"['Comedy', 'Drama', 'Music']"
2492,93,The Conjuring,20000000,137400141,318000141,298000141,2013,"['Horror', 'Mystery', 'Thriller']"
2494,95,Wonder,20000000,132422809,304604712,284604712,2017,"['Drama', 'Family']"
2497,98,Jackass 3D,20000000,117229692,171685793,151685793,2010,"['Action', 'Comedy', 'Documentary']"
2498,99,Bad Moms,20000000,113257297,180998716,160998716,2016,['Comedy']
2499,100,Glass,20000000,111035005,245303505,225303505,2016,"['Drama', 'Mystery', 'Thriller']"
2502,3,Tammy,20000000,84525432,96407655,76407655,2014,"['Comedy', 'Romance']"
2504,5,The Descendants,20000000,82624961,175507800,155507800,2011,"['Comedy', 'Drama']"
2505,6,School of Rock,20000000,81261177,131944672,111944672,2018,['Music']
2509,10,Mortal Kombat,20000000,70433227,122133227,102133227,2021,"['Action', 'Adventure', 'Fantasy']"
2511,12,Obsessed,20000000,68261644,73964713,53964713,2014,['Drama']
2514,15,The Last Song,20000000,62950384,92678948,72678948,2010,"['Drama', 'Music', 'Romance']"
2515,16,Why Did I Get Married Too?,20000000,60095852,60831067,40831067,2010,"['Comedy', 'Drama', 'Romance']"
2517,18,12 Years a Slave,20000000,56671993,181025343,161025343,2013,"['Biography', 'Drama', 'History']"
2519,20,Me Before You,20000000,56245075,208265198,188265198,2016,"['Drama', 'Romance']"
2520,21,What Men Want,20000000,54611903,69911903,49911903,2019,"['Comedy', 'Fantasy', 'Romance']"
2521,22,Barbershop: The Next Cut,20000000,54030051,54404202,34404202,2016,"['Comedy', 'Drama']"
2523,24,A Simple Favor,20000000,53548586,97628717,77628717,2018,"['Comedy', 'Crime', 'Drama']"
2524,25,Selma,20000000,52076908,66776576,46776576,2014,"['Biography', 'Drama', 'History']"
2533,34,Spotlight,20000000,45055776,92088460,72088460,2015,"['Crime', 'Drama']"
2534,35,Acrimony,20000000,43549096,46627836,26627836,2018,"['Drama', 'Romance', 'Thriller']"
2535,36,Max,20000000,42656255,43658157,23658157,2010,"['Biography', 'Comedy', 'Documentary']"
2537,38,Orphan,20000000,41596251,78769428,58769428,2016,['Drama']
2538,39,The Star,20000000,40847995,62758010,42758010,2017,"['Adventure', 'Animation', 'Comedy']"
2542,43,Nerve,20000000,38583626,70652284,50652284,2011,"['Comedy', 'Drama']"
2547,48,Risen,20000000,36880033,46255763,26255763,2010,"['Biography', 'Drama']"
2548,49,Vampires Suck,20000000,36661504,81424988,61424988,2010,['Comedy']
2549,50,The Black Hole,20000000,35841901,35841901,15841901,2016,"['Sci-Fi', 'Thriller']"
2550,51,The American,20000000,35606376,67950723,47950723,2010,"['Crime', 'Drama', 'Thriller']"
2552,53,A Very Harold & Kumar 3D Christmas,20000000,35061031,36265745,16265745,2011,"['Adventure', 'Comedy']"
2554,55,Texas Chainsaw 3D,20000000,34341945,47666013,27666013,2013,"['Horror', 'Thriller']"
2559,60,Copycat,20000000,32051917,32051917,12051917,2016,['Comedy']
2561,62,She's Out of My League,20000000,32010860,48680977,28680977,2010,"['Comedy', 'Romance']"
2562,63,Milk,20000000,31841299,57293371,37293371,2015,"['Documentary', 'Family']"
2564,65,The Debt,20000000,31177548,46604054,26604054,2010,"['Drama', 'Thriller']"
2568,69,Wild Things,20000000,29795299,55576699,35576699,2012,"['Documentary', 'Western']"
2573,74,Eye for an Eye,20000000,26792700,26792700,6792700,2019,['Drama']
2575,76,The World's End,20000000,26004851,47508505,27508505,2013,"['Action', 'Comedy', 'Sci-Fi']"
2577,78,You Again,20000000,25702053,32838945,12838945,2010,"['Comedy', 'Family', 'Romance']"
2580,81,On the Basis of Sex,20000000,24622687,38073377,18073377,2018,"['Biography', 'Drama']"
2581,82,Endless Love,20000000,23438250,34718173,14718173,2014,"['Drama', 'Romance']"
2582,83,The Covenant,20000000,23364784,38164784,18164784,2013,['Musical']
2583,84,Monte Carlo,20000000,23186769,39686769,19686769,2011,"['Adventure', 'Comedy', 'Family']"
2584,85,Stay Alive,20000000,23086480,23187506,3187506,2019,['Documentary']
2586,87,Rough Night,20000000,22105643,46844357,26844357,2017,"['Comedy', 'Crime', 'Thriller']"
2587,88,Psycho,20000000,21541218,37226218,17226218,2013,['Thriller']
2590,91,Shorts,20000000,20919166,29870801,9870801,2013,['Drama']
2591,92,Vampires,20000000,20268825,20268825,268825,2010,"['Comedy', 'Fantasy', 'Horror']"
2593,94,Secret in Their Eyes,20000000,20180155,32608019,12608019,2015,"['Crime', 'Drama', 'Mystery']"
2598,99,Under the Rainbow,20000000,18826490,18826490,-1173510,2013,"['Comedy', 'Drama', 'Romance']"
2615,16,Paparazzi,20000000,15712072,16612072,-3387928,2015,"['Action', 'Drama', 'Romance']"
2621,22,Lockout,20000000,14326865,33943049,13943049,2012,"['Action', 'Sci-Fi', 'Thriller']"
2623,24,What's Your Number?,20000000,14011084,30163785,10163785,2011,"['Comedy', 'Romance']"
2626,27,Burnt,20000000,13651946,36773510,16773510,2015,"['Comedy', 'Drama']"
2627,28,Envy,20000000,13548322,14566246,-5433754,2011,['Drama']
2630,31,Ghost Town,20000000,13367624,29958228,9958228,2018,"['Documentary', 'History']"
2632,33,Triple 9,20000000,12639297,25943792,5943792,2016,"['Crime', 'Thriller']"
2633,34,The Light Between Oceans,20000000,12545979,22281732,2281732,2016,"['Drama', 'Romance']"
2636,37,12 Rounds,20000000,12234694,17306648,-2693352,2017,"['Action', 'Drama', 'Romance']"
2637,38,Let Me In,20000000,12134935,28270399,8270399,2010,"['Drama', 'Fantasy', 'Horror']"
2646,47,Popstar: Never Stop Never Stopping,20000000,9496130,9537120,-10462880,2016,"['Comedy', 'Music']"
2647,48,Thank You for Your Service,20000000,9479390,9985316,-10014684,2015,"['Documentary', 'Drama']"
2648,49,Everybody's Fine,20000000,9208876,9208876,-10791124,2016,['Drama']
2650,51,Battle of the Year,20000000,8888355,16723377,-3276623,2013,"['Drama', 'Music']"
2653,54,The Man,20000000,8330720,10393696,-9606304,2017,['Drama']
2655,56,Inherent Vice,20000000,8110975,14772346,-5227654,2014,"['Comedy', 'Crime', 'Drama']"
2657,58,Machete Kills,20000000,8008161,18273009,-1726991,2013,"['Action', 'Crime', 'Sci-Fi']"
2660,61,Proof,20000000,7535331,8284331,-11715669,2017,"['Comedy', 'Mystery', 'Sci-Fi']"
2662,63,Willard,20000000,6882696,6882696,-13117304,2017,['Drama']
2664,65,Little Boy,20000000,6485961,17769299,-2230701,2015,"['Drama', 'History', 'War']"
2666,67,Chasing Mavericks,20000000,6002756,8300821,-11699179,2012,"['Biography', 'Drama', 'Sport']"
2667,68,A Most Violent Year,20000000,5749134,8846875,-11153125,2014,"['Crime', 'Drama', 'Thriller']"
2668,69,A Dangerous Method,20000000,5702083,14807531,-5192469,2011,"['Biography', 'Drama', 'Romance']"
2672,73,Birth,20000000,5005899,14603001,-5396999,2015,"['Adventure', 'Documentary']"
2673,74,Hands of Stone,20000000,4712792,5031975,-14968025,2016,"['Action', 'Biography', 'Drama']"
2677,78,The Cold Light of Day,20000000,3763583,25361206,5361206,2012,"['Action', 'Thriller']"
2680,81,Suspiria,20000000,2483472,7034615,-12965385,2018,"['Fantasy', 'Horror', 'Mystery']"
2681,82,LBJ,20000000,2468683,2507181,-17492819,2016,"['Biography', 'Drama', 'History']"
2684,85,My All-American,20000000,2246000,2246000,-17754000,2015,"['Biography', 'Drama', 'Sport']"
2688,89,Equilibrium,20000000,1190018,5345869,-14654131,2012,"['Comedy', 'Mystery', 'Thriller']"
2689,90,Dylan Dog: Dead of Night,20000000,1186538,6093725,-13906275,2010,"['Action', 'Comedy', 'Crime']"
2693,94,Middle Men,20000000,754301,754301,-19245699,2010,"['Action', 'Comedy', 'Crime']"
2695,96,All Good Things,20000000,582024,873617,-19126383,2010,"['Crime', 'Drama', 'Mystery']"
2696,97,By the Sea,20000000,538460,3727746,-16272254,2015,"['Drama', 'Romance']"
2700,1,The Tempest,20000000,277943,277943,-19722057,2010,"['Comedy', 'Drama', 'Fantasy']"
2705,6,Regression,20000000,55039,15824374,-4175626,2015,"['Crime', 'Horror', 'Mystery']"
2706,7,Admiral,20000000,0,38585047,18585047,2015,"['Action', 'Adventure', 'Biography']"
2707,8,Zambezia,20000000,0,34454336,14454336,2012,"['Adventure', 'Animation', 'Comedy']"
2710,11,Survivor,20000000,0,1703281,-18296719,2012,"['Biography', 'Crime', 'Documentary']"
2711,12,The History of Love,20000000,0,476624,-19523376,2016,"['Drama', 'Romance', 'War']"
2713,14,Dwegons and Leprechauns,20000000,0,0,-20000000,2014,['Animation']
2714,15,Fight Valley,20000000,0,0,-20000000,2016,"['Action', 'Drama']"
2716,17,Bird Box,19800000,0,0,-19800000,2018,"['Drama', 'Horror', 'Sci-Fi']"
2718,19,The Shape of Water,19500000,63859435,195790794,176290794,2017,"['Adventure', 'Drama', 'Fantasy']"
2721,22,The Frozen Ground,19200000,0,5617460,-13582540,2013,"['Crime', 'Drama', 'Mystery']"
2722,23,The Devil's Double,19100000,1361512,5965646,-13134354,2011,"['Biography', 'Drama', 'Thriller']"
2726,27,Bad Teacher,19000000,100292856,215448997,196448997,2011,"['Comedy', 'Romance']"
2727,28,Sausage Party,19000000,97670358,141344255,122344255,2016,"['Adventure', 'Animation', 'Comedy']"
2728,29,Sea of Love,19000000,58571513,58571513,39571513,2016,"['Drama', 'Mystery', 'Romance']"
2735,36,The Crazies,19000000,39123589,56445534,37445534,2010,"['Horror', 'Thriller']"
2738,39,The Switch,19000000,27758465,49858465,30858465,2010,"['Comedy', 'Drama', 'Romance']"
2739,40,Leap Year,19000000,25918920,32618920,13618920,2010,"['Comedy', 'Romance']"
2740,41,The Book Thief,19000000,21488481,76086711,57086711,2013,"['Drama', 'War']"
2746,47,Firestorm,19000000,8123860,8123860,-10876140,2010,['Documentary']
2747,48,Take Me Home Tonight,19000000,6928068,7576604,-11423396,2011,"['Comedy', 'Drama', 'Romance']"
2748,49,Won't Back Down,19000000,5310554,5745503,-13254497,2012,['Drama']
2749,50,Action Point,19000000,5059608,5103675,-13896325,2018,['Comedy']
2762,63,Left Behind,18500000,4221341,4221341,-14278659,2012,"['Horror', 'Mystery', 'Thriller']"
2763,64,Neighbors,18000000,150086800,270944428,252944428,2014,['Comedy']
2765,66,The Mask,18000000,119920129,351620129,333620129,2012,"['Documentary', 'Drama', 'Family']"
2766,67,Big,18000000,114968774,151668774,133668774,2017,['Documentary']
2776,77,My Big Fat Greek Wedding 2,18000000,59689605,92096558,74096558,2016,"['Comedy', 'Romance']"
2777,78,The Perfect Guy,18000000,57027435,60278166,42278166,2015,"['Crime', 'Drama', 'Horror']"
2779,80,Diary of a Wimpy Kid: Rodrick Rules,18000000,52698535,73695194,55695194,2011,"['Comedy', 'Family']"
2782,83,Soul Surfer,18000000,43853424,47158652,29158652,2011,"['Biography', 'Drama', 'Family']"
2784,85,Uncle Drew,18000000,42469946,46527161,28527161,2018,"['Comedy', 'Sport']"
2785,86,Birdman or (The Unexpected Virtue of Ignorance),18000000,42340598,103215094,85215094,2014,"['Comedy', 'Drama']"
2789,90,Blue Jasmine,18000000,33404871,102912961,84912961,2013,['Drama']
2791,92,Honey,18000000,30272254,62646763,44646763,2010,['Drama']
2794,95,Ricki and the Flash,18000000,26839498,41166033,23166033,2015,"['Comedy', 'Drama', 'Music']"
2795,96,Glory,18000000,26593580,26593580,8593580,2013,"['Comedy', 'Drama']"
2797,98,Love the Coopers,18000000,26302731,42227490,24227490,2015,"['Comedy', 'Fantasy', 'Romance']"
2801,2,Love Happens,18000000,22965110,36133014,18133014,2010,['Drama']
2802,3,Fame,18000000,22455510,80227619,62227619,2017,['Documentary']
2803,4,The Circle,18000000,20497844,40651864,22651864,2015,"['Drama', 'Fantasy', 'Horror']"
2805,6,127 Hours,18000000,18335230,60217171,42217171,2010,"['Adventure', 'Biography', 'Drama']"
2808,9,Norm of the North,18000000,17062499,30535660,12535660,2016,"['Adventure', 'Animation', 'Comedy']"
2810,11,Jobs,18000000,16131410,43402515,25402515,2013,"['Biography', 'Drama']"
2813,14,And So It Goes,18000000,15160801,17920013,-79987,2014,"['Comedy', 'Drama', 'Romance']"
2818,19,Labor Day,18000000,13371528,14189810,-3810190,2013,"['Drama', 'Romance']"
2819,20,Getaway,18000000,10501938,11813989,-6186011,2013,"['Action', 'Crime', 'Thriller']"
2824,25,The Last Station,18000000,6617867,15696146,-2303854,2011,['Drama']
2825,26,Dragonslayer,18000000,6000000,6000000,-12000000,2011,['Documentary']
2831,32,Hamlet,18000000,4501094,7129670,-10870330,2011,['Drama']
2832,33,The Railway Man,18000000,4438438,23910210,5910210,2013,"['Biography', 'Drama', 'Romance']"
2833,34,Restoration,18000000,4100000,4100000,-13900000,2011,['Drama']
2834,35,Midnight Special,18000000,3712282,7680250,-10319750,2016,"['Action', 'Drama', 'Mystery']"
2835,36,Miss Sloane,18000000,3500605,7719630,-10280370,2016,"['Drama', 'Thriller']"
2836,37,Metallica Through the Never,18000000,3419967,9082906,-8917094,2013,['Music']
2838,39,Unforgettable,18000000,2483790,2483790,-15516210,2010,['Documentary']
2842,43,Phantom,18000000,1034589,1199510,-16800490,2013,"['Drama', 'History', 'Thriller']"
2843,44,The Salton Sea,18000000,676698,676698,-17323302,2016,"['Crime', 'Drama', 'Mystery']"
2847,48,Renaissance,18000000,70644,2401413,-15598587,2016,"['Drama', 'Romance', 'Sci-Fi']"
2849,50,I Am Wrath,18000000,0,309608,-17690392,2016,"['Action', 'Crime', 'Drama']"
2850,51,Wolves,18000000,0,94953,-17905047,2014,"['Action', 'Fantasy', 'Horror']"
2852,53,The Prince,18000000,0,0,-18000000,2014,"['Action', 'Thriller']"
2853,54,Forsaken,18000000,0,0,-18000000,2015,"['Action', 'Drama', 'Western']"
2855,56,Red Lights,17700000,49521,14518884,-3181116,2012,"['Drama', 'Fantasy', 'Horror']"
2859,60,Hoodwinked,17500000,51386611,109843390,92343390,2012,['Documentary']
2862,63,Black Nativity,17500000,7018188,7285135,-10214865,2013,"['Drama', 'Family', 'Music']"
2863,64,City of Ghosts,17500000,325491,325491,-17174509,2017,"['Documentary', 'War']"
2865,66,A Quiet Place,17000000,188024361,334522294,317522294,2016,['Documentary']
2867,68,Aliens,17000000,85160248,183316455,166316455,2014,"['Comedy', 'Mystery', 'Sci-Fi']"
2870,71,My Fair Lady,17000000,72000000,72071636,55071636,2019,['Musical']
2872,73,The Best Man Holiday,17000000,70525195,72835710,55835710,2013,"['Comedy', 'Drama']"
2874,75,Pitch Perfect,17000000,65001093,116044347,99044347,2012,"['Comedy', 'Music', 'Romance']"
2876,77,Evil Dead,17000000,54239856,97778356,80778356,2013,"['Fantasy', 'Horror', 'Thriller']"
2879,80,"McFarland, USA",17000000,44480275,45707924,28707924,2015,"['Biography', 'Drama', 'Sport']"
2880,81,Almost Christmas,17000000,42065185,42493506,25493506,2016,"['Comedy', 'Drama']"
2886,87,Beastly,17000000,27865571,38028230,21028230,2011,"['Drama', 'Fantasy', 'Romance']"
2889,90,Lottery Ticket,17000000,24719879,24719879,7719879,2010,['Comedy']
2900,1,American Dreamz,17000000,7314027,16510971,-489029,2017,"['Comedy', 'Documentary']"
2903,4,The Apparition,17000000,4936819,10637281,-6362719,2012,"['Horror', 'Thriller']"
2909,10,Genius,17000000,1361045,7265283,-9734717,2016,"['Biography', 'Drama']"
2911,12,Escobar: Paradise Lost,17000000,195792,3917679,-13082321,2014,"['Crime', 'Drama', 'History']"
2915,16,Crawl,17000000,0,0,-17000000,2011,"['Crime', 'Thriller']"
2916,17,The Young Messiah,16800000,6469813,7313697,-9486303,2016,"['Drama', 'Fantasy']"
2918,19,My Girl,16500000,58011485,58011485,41511485,2010,['Drama']
2921,22,The Illusionist,16500000,39868642,83792062,67292062,2010,"['Animation', 'Drama']"
2929,30,Road Trip,16000000,68525609,119739110,103739110,2013,['Horror']
2932,33,Moonrise Kingdom,16000000,45512466,68848446,52848446,2012,"['Adventure', 'Comedy', 'Drama']"
2933,34,The Artist,16000000,44667095,128256712,112256712,2011,"['Comedy', 'Drama', 'Romance']"
2934,35,The Unborn,16000000,42670410,78208812,62208812,2019,['Horror']
2938,39,The Roommate,16000000,37300107,52545707,36545707,2011,"['Drama', 'Thriller']"
2942,43,Baby Boy,16000000,28734552,28734552,12734552,2017,['Drama']
2950,51,Remember Me,16000000,19068240,56506120,40506120,2010,"['Drama', 'Romance']"
2959,60,People Like Us,16000000,12431792,12617472,-3382528,2012,"['Comedy', 'Drama']"
2964,65,Bleed for This,16000000,5083906,6603926,-9396074,2016,"['Biography', 'Drama', 'Sport']"
2969,70,The Homesman,16000000,2429989,8217571,-7782429,2014,"['Drama', 'Western']"
2970,71,Trance,16000000,2322593,22594052,6594052,2010,['Horror']
2971,72,The Immigrant,16000000,2013456,7585011,-8414989,2013,"['Drama', 'Romance']"
2972,73,Steel,16000000,1686429,1686429,-14313571,2019,['Western']
2977,78,Good,16000000,31631,31631,-15968369,2018,['Documentary']
2978,79,Vamps,16000000,3361,94812,-15905188,2012,"['Comedy', 'Horror', 'Romance']"
2981,82,Zulu,16000000,0,1844228,-14155772,2013,"['Crime', 'Drama', 'Thriller']"
2982,83,Second Act,15700000,39282227,63288854,47588854,2018,"['Comedy', 'Drama', 'Romance']"
2987,88,Madison,15500000,517262,517262,-14982738,2020,"['Adventure', 'Drama', 'Family']"
2999,100,Twins,15000000,111936388,216600000,201600000,2016,"['Adventure', 'Biography', 'Comedy']"
3001,2,Annabelle: Creation,15000000,102092201,305384865,290384865,2017,"['Horror', 'Mystery', 'Thriller']"
3004,5,The Color Purple,15000000,93589701,93589701,78589701,2010,"['Action', 'Drama']"
3005,6,The Imitation Game,15000000,91125143,227740463,212740463,2014,"['Biography', 'Drama', 'Thriller']"
3008,9,Mama,15000000,71628180,148095566,133095566,2010,['Drama']
3012,13,Diary of a Wimpy Kid,15000000,64003625,76954311,61954311,2010,"['Comedy', 'Drama', 'Family']"
3014,15,Halloween,15000000,58269151,77514401,62514401,2018,"['Horror', 'Thriller']"
3015,16,The Queen,15000000,56441711,128885873,113885873,2012,"['Action', 'Drama', 'War']"
3017,18,The Woman in Black,15000000,54333290,128955898,113955898,2012,"['Drama', 'Fantasy', 'Horror']"
3018,19,Little Women,15000000,50003303,50003303,35003303,2019,"['Drama', 'Romance']"
3019,20,The Deer Hunter,15000000,50000000,50009253,35009253,2015,['Documentary']
3020,21,BlacKkKlansman,15000000,49275340,93017335,78017335,2018,"['Biography', 'Crime', 'Drama']"
3025,26,Snitch,15000000,42930462,57907734,42907734,2013,"['Action', 'Drama', 'Thriller']"
3027,28,Krampus,15000000,42725475,61788393,46788393,2015,"['Comedy', 'Fantasy', 'Horror']"
3028,29,End of Watch,15000000,41003371,57586606,42586606,2012,"['Action', 'Crime', 'Drama']"
3032,33,Wild,15000000,37880356,52460543,37460543,2014,"['Adventure', 'Biography', 'Drama']"
3034,35,The Theory of Everything,15000000,35893537,123327692,108327692,2014,"['Biography', 'Drama', 'Romance']"
3035,36,Drive,15000000,35060689,81357930,66357930,2011,"['Crime', 'Drama']"
3037,38,Hawaii,15000000,34562222,34562222,19562222,2013,"['Drama', 'Romance']"
3038,39,The Favourite,15000000,34366783,94113929,79113929,2018,"['Biography', 'Drama', 'History']"
3041,42,Where the Heart Is,15000000,33771174,40862054,25862054,2012,"['Biography', 'Documentary', 'Family']"
3049,50,When the Game Stands Tall,15000000,30127963,30138912,15138912,2014,"['Drama', 'Family', 'Sport']"
3056,57,Home Again,15000000,27020284,37336874,22336874,2012,['Drama']
3059,60,Ramona and Beezus,15000000,26167002,27469621,12469621,2010,"['Adventure', 'Comedy', 'Family']"
3060,61,The November Man,15000000,25018119,34820335,19820335,2014,"['Action', 'Crime', 'Thriller']"
3064,65,Nowhere to Run,15000000,22189039,52189039,37189039,2015,['Thriller']
3066,67,The Place Beyond the Pines,15000000,21403519,47011449,32011449,2012,"['Crime', 'Drama', 'Thriller']"
3069,70,Keanu,15000000,20591853,20688141,5688141,2016,"['Action', 'Comedy', 'Crime']"
3070,71,Country Strong,15000000,20218921,20601987,5601987,2010,"['Drama', 'Music']"
3075,76,A Most Wanted Man,15000000,17237855,36068890,21068890,2014,"['Crime', 'Drama', 'Thriller']"
3078,79,The Man with the Iron Fists,15000000,15634090,22018988,7018988,2012,['Action']
3079,80,Firestarter,15000000,15136870,15136870,136870,2019,['Documentary']
3080,81,Miss Bala,15000000,14998027,15362298,362298,2011,"['Crime', 'Drama', 'Thriller']"
3081,82,Killing Them Softly,15000000,14945541,39238443,24238443,2012,"['Crime', 'Thriller']"
3083,84,One Day,15000000,13843771,59168692,44168692,2011,"['Drama', 'Romance']"
3089,90,The Founder,15000000,12786053,24403192,9403192,2012,"['Comedy', 'Sci-Fi']"
3093,94,The Muse,15000000,11614954,11614954,-3385046,2011,"['Horror', 'Mystery', 'Thriller']"
3102,3,Dark Blue,15000000,9237470,12262065,-2737935,2019,['Drama']
3104,5,Brainstorm,15000000,8921050,8921050,-6078950,2015,['Thriller']
3105,6,Queen of Katwe,15000000,8874389,10055481,-4944519,2016,"['Biography', 'Drama', 'Sport']"
3106,7,Whatever it Takes,15000000,8735529,8735529,-6264471,2011,"['Documentary', 'Drama']"
3108,9,The Importance of Being Earnest,15000000,8378141,8378141,-6621859,2015,['Comedy']
3109,10,The Love Letter,15000000,8322608,9010980,-5989020,2011,"['Adventure', 'Documentary']"
3112,13,Promised Land,15000000,7597898,12394562,-2605438,2012,['Drama']
3114,15,Hotel Artemis,15000000,6708137,12758799,-2241201,2018,"['Action', 'Drama', 'Sci-Fi']"
3124,25,Scouts Guide to the Zombie Apocalypse,15000000,3703046,15554855,554855,2015,"['Action', 'Comedy', 'Horror']"
3126,27,You Will Meet a Tall Dark Stranger,15000000,3247816,34247816,19247816,2010,"['Comedy', 'Drama', 'Romance']"
3127,28,Rock the Kasbah,15000000,3020665,3386153,-11613847,2015,"['Comedy', 'Music', 'War']"
3128,29,Never Let Me Go,15000000,2434652,11173718,-3826282,2010,"['Drama', 'Romance', 'Sci-Fi']"
3129,30,The Disappointments Room,15000000,2423467,3503761,-11496239,2016,"['Drama', 'Horror', 'Thriller']"
3134,35,The Comedian,15000000,1658706,1658706,-13341294,2012,"['Drama', 'Romance']"
3138,39,Metropolis,15000000,673414,1405032,-13594968,2014,['Documentary']
3141,42,The Reluctant Fundamentalist,15000000,528731,528731,-14471269,2012,"['Drama', 'Thriller']"
3142,43,The Return,15000000,501752,5953886,-9046114,2012,['Drama']
3145,46,Centurion,15000000,123570,7885048,-7114952,2010,"['Action', 'Adventure', 'Drama']"
3149,50,Winnie Mandela,15000000,61847,61847,-14938153,2011,"['Biography', 'Drama', 'History']"
3150,51,The Son of No One,15000000,30680,1148578,-13851422,2011,"['Action', 'Crime', 'Drama']"
3153,54,Khumba,15000000,0,20898221,5898221,2013,"['Adventure', 'Animation', 'Family']"
3154,55,A Few Best Men,15000000,0,17224539,2224539,2011,"['Comedy', 'Romance']"
3157,58,Bathory,15000000,0,3436763,-11563237,2011,['Drama']
3160,61,In Dubious Battle,15000000,0,214182,-14785818,2016,['Drama']
3161,62,Broken Horses,15000000,0,3471,-14996529,2015,"['Action', 'Crime', 'Drama']"
3163,64,Blinded by the Light,15000000,0,0,-15000000,2019,"['Biography', 'Comedy', 'Drama']"
3165,66,Magic Mike XXL,14500000,66013057,123660597,109160597,2015,"['Comedy', 'Drama', 'Music']"
3168,69,Freedom,14500000,0,872757,-13627243,2012,"['Crime', 'Drama', 'Thriller']"
3169,70,Unforgiven,14400000,101157447,159157447,144757447,2013,"['Action', 'Crime', 'Drama']"
3180,81,The Possession,14000000,49130588,82925064,68925064,2012,"['Horror', 'Mystery', 'Thriller']"
3183,84,Urban Legend,14000000,38116707,72571864,58571864,2016,['Horror']
3186,87,White Fang,14000000,34729091,34729091,20729091,2018,"['Adventure', 'Animation']"
3188,89,Superstar,14000000,30628981,30628981,16628981,2012,['Drama']
3189,90,The Iron Lady,14000000,29959436,115592104,101592104,2011,"['Biography', 'Drama']"
3194,95,Our Family Wedding,14000000,20255281,21410546,7410546,2010,"['Comedy', 'Romance']"
3206,7,Hot Tub Time Machine 2,14000000,12314651,12826644,-1173356,2015,"['Comedy', 'Mystery', 'Sci-Fi']"
3207,8,Bobby,14000000,11242801,20597806,6597806,2016,"['Biography', 'Documentary', 'Sport']"
3208,9,Head Over Heels,14000000,10397365,10397365,-3602635,2010,['Comedy']
3209,10,Fun Size,14000000,9409538,11166615,-2833385,2012,"['Adventure', 'Comedy']"
3210,11,Lost and Found,14000000,6552255,6552255,-7447745,2019,['Thriller']
3215,16,Suffragette,14000000,4702420,34044909,20044909,2015,"['Biography', 'Drama', 'History']"
3217,18,Mr. Turner,14000000,3958546,25187026,11187026,2014,"['Biography', 'Drama', 'History']"
3221,22,Flipped,14000000,1755212,4289993,-9710007,2010,"['Comedy', 'Drama', 'Romance']"
3224,25,Amen,14000000,274299,274299,-13725701,2011,['Drama']
3225,26,The Lucky Ones,14000000,266967,266967,-13733033,2015,"['Drama', 'Thriller']"
3226,27,Margaret,14000000,47185,623292,-13376708,2011,['Drama']
3227,28,Reign of Assassins,14000000,0,11354230,-2645770,2010,"['Action', 'Adventure']"
3231,32,Ca$h,13700000,0,11738256,-1961744,2010,"['Crime', 'Thriller']"
3235,36,Seven Psychopaths,13500000,15024049,33035736,19535736,2012,"['Comedy', 'Crime']"
3240,41,The Last Godfather,13400000,164247,164247,-13235753,2010,"['Comedy', 'Crime', 'Romance']"
3241,42,Under the Skin,13300000,2614251,7229933,-6070067,2013,"['Drama', 'Horror', 'Sci-Fi']"
3243,44,No Good Deed,13200000,52543632,54323210,41123210,2014,"['Action', 'Crime', 'Drama']"
3245,46,Black Swan,13000000,106954678,331266710,318266710,2010,"['Drama', 'Thriller']"
3247,48,Justin Bieber: Never Say Never,13000000,73013910,99034125,86034125,2011,"['Documentary', 'Music']"
3248,49,The First Purge,13000000,69488745,136617305,123617305,2018,"['Action', 'Horror', 'Sci-Fi']"
3249,50,Miracles from Heaven,13000000,61705123,73798736,60798736,2016,"['Biography', 'Drama', 'Family']"
3250,51,Snow Day,13000000,60008303,62452927,49452927,2014,"['Action', 'Documentary', 'Drama']"
3251,52,The Butterfly Effect,13000000,57924679,95638592,82638592,2010,"['Comedy', 'Crime', 'Drama']"
3253,54,The Shallows,13000000,55121623,118763442,105763442,2016,"['Drama', 'Horror', 'Thriller']"
3257,58,About Last Night,13000000,48637684,50445860,37445860,2014,"['Comedy', 'Romance']"
3260,61,St. Vincent,13000000,44137712,54837234,41837234,2014,"['Comedy', 'Drama']"
3261,62,Earth to Echo,13000000,38934842,42174545,29174545,2014,"['Adventure', 'Family', 'Sci-Fi']"
3271,72,Ex Machina,13000000,25440971,38358392,25358392,2014,"['Drama', 'Mystery', 'Sci-Fi']"
3274,75,Eye in the Sky,13000000,18704596,35402802,22402802,2015,"['Drama', 'Thriller', 'War']"
3275,76,Admission,13000000,18007317,18733666,5733666,2013,"['Comedy', 'Drama', 'Romance']"
3276,77,The Perks of Being a Wallflower,13000000,17742948,33069303,20069303,2012,['Drama']
3279,80,Room,13000000,14677674,36262783,23262783,2015,"['Drama', 'Thriller']"
3280,81,Woodlawn,13000000,14394097,14403703,1403703,2015,"['Drama', 'Sport']"
3284,85,Dirty Work,13000000,10020081,10020081,-2979919,2016,"['Crime', 'Drama']"
3285,86,Bajrangi Bhaijaan,13000000,8178001,121778347,108778347,2015,"['Action', 'Comedy', 'Drama']"
3296,97,Chloe,13000000,3075255,11831131,-1168869,2013,"['Drama', 'Music', 'Romance']"
3298,99,Youth,13000000,2703296,24001573,11001573,2012,"['Drama', 'Family']"
3302,3,The Vatican Tapes,13000000,1784763,14929184,1929184,2015,"['Horror', 'Thriller']"
3306,7,Attack the Block,13000000,1024175,6459183,-6540817,2011,"['Action', 'Comedy', 'Sci-Fi']"
3308,9,The Claim,13000000,622023,1375635,-11624365,2017,['Drama']
3310,11,The Killer Inside Me,13000000,217277,3617277,-9382723,2010,"['Crime', 'Drama', 'Horror']"
3311,12,Womb,13000000,0,0,-13000000,2010,"['Drama', 'Romance', 'Sci-Fi']"
3313,14,The Call,12800000,51872378,69821476,57021476,2013,"['Crime', 'Drama', 'Horror']"
3315,16,The Drop,12600000,10724389,19054534,6454534,2014,"['Crime', 'Drama']"
3317,18,Machete,12500000,26593646,46370970,33870970,2010,"['Action', 'Crime', 'Thriller']"
3327,28,Conviction,12500000,6797696,11826980,-673020,2010,"['Biography', 'Crime', 'Drama']"
3331,32,Casino Jack,12500000,2039869,2272186,-10227814,2010,"['Biography', 'Comedy', 'Crime']"
3336,37,The Paperboy,12500000,677200,4027663,-8472337,2012,"['Crime', 'Drama', 'Mystery']"
3338,39,A Little Bit of Heaven,12500000,10011,1100287,-11399713,2011,"['Comedy', 'Drama', 'Fantasy']"
3342,43,The Fault in Our Stars,12000000,124872350,307166834,295166834,2014,"['Drama', 'Romance']"
3344,45,Think Like a Man,12000000,91547205,113373764,101373764,2012,"['Comedy', 'Romance']"
3346,47,The Golden Child,12000000,79817937,79817937,67817937,2012,['Drama']
3351,52,Act of Valor,12000000,70012847,82497035,70497035,2012,"['Action', 'Adventure', 'Drama']"
3352,53,Witness,12000000,65532576,65532576,53532576,2012,"['Action', 'Crime', 'Drama']"
3353,54,Step Up,12000000,65328121,110989157,98989157,2012,"['Biography', 'Documentary', 'Drama']"
3354,55,Chronicle,12000000,64575175,123681790,111681790,2012,"['Drama', 'Sci-Fi', 'Thriller']"
3357,58,Project X,12000000,54731865,103028188,91028188,2012,['Comedy']
3358,59,"Three Billboards Outside Ebbing, Missouri",12000000,54513740,160191915,148191915,2017,"['Crime', 'Drama']"
3359,60,Lion,12000000,51739495,149570720,137570720,2015,"['Comedy', 'Drama', 'Romance']"
3360,61,Overboard,12000000,50316123,85369830,73369830,2018,"['Comedy', 'Romance']"
3364,65,Philomena,12000000,37709979,98963392,86963392,2013,"['Biography', 'Comedy', 'Drama']"
3366,67,Crossroads,12000000,37188667,57000000,45000000,2011,['Drama']
3367,68,Paper Towns,12000000,32000304,85450484,73450484,2015,"['Comedy', 'Drama', 'Mystery']"
3368,69,Quarantine,12000000,31691811,41924774,29924774,2011,"['Documentary', 'Family']"
3376,77,Hell or High Water,12000000,27007844,37584304,25584304,2016,"['Action', 'Crime', 'Drama']"
3378,79,Katy Perry: Part of Me,12000000,25326071,32700439,20700439,2012,"['Documentary', 'Music']"
3379,80,Top Five,12000000,25317379,26001741,14001741,2014,"['Comedy', 'Romance']"
3382,83,Prophecy,12000000,22673340,22673340,10673340,2015,['Mystery']
3383,84,Project Almanac,12000000,22348241,32909437,20909437,2015,"['Drama', 'Mystery', 'Sci-Fi']"
3384,85,Just Wright,12000000,21540363,21867665,9867665,2010,"['Comedy', 'Romance', 'Sport']"
3390,91,Nebraska,12000000,17654912,24761360,12761360,2013,"['Adventure', 'Comedy', 'Drama']"
3393,94,Young Adult,12000000,16311571,22750356,10750356,2011,"['Comedy', 'Drama']"
3394,95,About Time,12000000,15323921,89309178,77309178,2013,"['Comedy', 'Drama', 'Fantasy']"
3395,96,If Beale Street Could Talk,12000000,14915773,19859167,7859167,2018,"['Drama', 'Romance']"
3396,97,Wish Upon,12000000,14301505,23477345,11477345,2017,"['Drama', 'Fantasy', 'Horror']"
3406,7,Marshall,12000000,10051659,10116816,-1883184,2017,"['Biography', 'Crime', 'Drama']"
3408,9,Arbitrage,12000000,7919574,35830713,23830713,2012,"['Drama', 'Thriller']"
3410,11,Screwed,12000000,6982680,6982680,-5017320,2011,"['Crime', 'Drama']"
3412,13,Fortress,12000000,6730578,46730578,34730578,2012,"['Documentary', 'Drama', 'News']"
3413,14,For Greater Glory: The True Story of Cristiada,12000000,5669081,10026255,-1973745,2012,"['Drama', 'History', 'War']"
3426,27,Ravenous,12000000,2062406,2062406,-9937594,2017,"['Drama', 'Horror', 'Sci-Fi']"
3428,29,Stoker,12000000,1703125,12034913,34913,2013,"['Drama', 'Thriller']"
3431,32,Kill the Irishman,12000000,1188194,1188194,-10811806,2011,"['Biography', 'Crime', 'Drama']"
3432,33,Duma,12000000,870067,994790,-11005210,2011,"['Biography', 'Crime', 'Documentary']"
3433,34,Darling Companion,12000000,793352,1200346,-10799654,2012,"['Comedy', 'Drama', 'Romance']"
3435,36,Brother,12000000,450594,450594,-11549406,2010,"['Drama', 'Family', 'Sport']"
3439,40,Trade,12000000,214202,1513388,-10486612,2019,['Drama']
3440,41,Fateless,12000000,196857,196857,-11803143,2017,['Comedy']
3445,46,Trash,12000000,17484,6553186,-5446814,2019,['Thriller']
3446,47,5 Days of War,12000000,17479,87793,-11912207,2011,"['Action', 'Drama', 'War']"
3447,48,10 Days in a Madhouse,12000000,14616,14616,-11985384,2015,['Drama']
3451,52,Triangle,12000000,0,1594955,-10405045,2011,"['Family', 'Fantasy', 'Music']"
3453,54,Drive Hard,12000000,0,0,-12000000,2014,"['Action', 'Comedy', 'Crime']"
3456,57,The Dressmaker,11900000,2022115,24041617,12141617,2015,"['Comedy', 'Drama']"
3459,60,Carol,11800000,12711491,42843521,31043521,2015,"['Drama', 'Romance']"
3461,62,Dirty Grandpa,11500000,35593113,105078449,93578449,2016,['Comedy']
3467,68,The Fighter,11000000,93617009,129262388,118262388,2010,"['Biography', 'Drama', 'Sport']"
3472,73,If I Stay,11000000,50474843,78356170,67356170,2014,"['Drama', 'Fantasy', 'Music']"
3478,79,Brooklyn,11000000,38322743,62076141,51076141,2015,"['Drama', 'Romance']"
3480,81,Woman in Gold,11000000,33307793,58586407,47586407,2015,"['Biography', 'Drama', 'History']"
3482,83,"I, Tonya",11000000,30014534,53797409,42797409,2017,"['Biography', 'Comedy', 'Drama']"
3489,90,Quartet,11000000,18388357,56178935,45178935,2012,"['Comedy', 'Drama']"
3493,94,Inside Llewyn Davis,11000000,13248209,32943247,21943247,2013,"['Drama', 'Music']"
3494,95,Frailty,11000000,13110448,19947280,8947280,2012,['Drama']
3497,98,Peeples,11000000,9177065,9307166,-1692834,2013,"['Comedy', 'Romance']"
3499,100,Sultan,11000000,5599781,72989781,61989781,2012,"['Drama', 'Romance']"
3501,2,The Gospel of John,11000000,4068087,4234355,-6765645,2014,['Drama']
3504,5,Othello,11000000,2844379,2844379,-8155621,2015,['Thriller']
3510,11,Brighton Rock,11000000,229653,229653,-10770347,2010,"['Crime', 'Drama', 'Thriller']"
3513,14,LOL,11000000,0,10431506,-568494,2012,"['Comedy', 'Drama', 'Romance']"
3514,15,Misconduct,11000000,0,2352511,-8647489,2016,"['Crime', 'Drama', 'Mystery']"
3515,16,Eli,11000000,0,0,-11000000,2015,['Comedy']
3522,23,An Ideal Husband,10700000,18542974,31341183,20641183,2018,['Comedy']
3523,24,Darkness,10600000,22163442,34409206,23809206,2015,['Drama']
3524,25,The Last Days on Mars,10600000,24084,261364,-10338636,2013,"['Adventure', 'Horror', 'Sci-Fi']"
3532,33,Lovesick,10100000,10143618,10143618,43618,2019,"['Comedy', 'Drama']"
3533,34,Housefull,10100000,1183658,18726300,8626300,2010,['Comedy']
3539,40,Stripes,10000000,85300000,85300000,75300000,2017,['Drama']
3541,42,The Purge: Election Year,10000000,79042440,118514727,108514727,2016,"['Action', 'Horror', 'Sci-Fi']"
3542,43,Book Club,10000000,68566296,91113683,81113683,2015,['Documentary']
3544,45,Insidious: The Last Key,10000000,67745330,167885588,157885588,2018,"['Horror', 'Mystery', 'Thriller']"
3552,53,Lady Bird,10000000,48958273,78610769,68610769,2017,"['Comedy', 'Drama']"
3554,55,The Best Exotic Marigold Hotel,10000000,46383639,134639780,124639780,2011,"['Comedy', 'Drama', 'Romance']"
3555,56,Hereditary,10000000,44069456,70133905,60133905,2018,"['Drama', 'Horror', 'Mystery']"
3556,57,"Love, Simon",10000000,40826341,65520633,55520633,2018,"['Comedy', 'Drama', 'Romance']"
3560,61,Jigsaw,10000000,38052832,102445196,92445196,2017,"['Crime', 'Horror', 'Mystery']"
3567,68,The Boy,10000000,35819556,68220952,58220952,2015,"['Drama', 'Horror', 'Thriller']"
3568,69,Commando,10000000,35073978,35073978,25073978,2013,"['Action', 'Thriller']"
3569,70,"Everything, Everything",10000000,34121140,61603136,51603136,2017,"['Drama', 'Romance']"
3570,71,Devil,10000000,33679655,63354114,53354114,2010,"['Horror', 'Mystery', 'Thriller']"
3572,73,The Second Best Exotic Marigold Hotel,10000000,33078266,90384306,80384306,2015,"['Comedy', 'Drama']"
3574,75,How to Be a Latin Lover,10000000,32149404,62556228,52556228,2017,"['Comedy', 'Drama']"
3577,78,Calendar Girls,10000000,31011616,93074616,83074616,2015,['Drama']
3579,80,Slender Man,10000000,30564825,51723644,41723644,2018,"['Horror', 'Mystery', 'Thriller']"
3584,85,When the Bough Breaks,10000000,29747603,30768449,20768449,2016,"['Crime', 'Drama', 'Horror']"
3590,91,Sinister 2,10000000,27740955,54104225,44104225,2015,"['Horror', 'Mystery', 'Thriller']"
3591,92,The Forest,10000000,26594261,40749230,30749230,2011,"['Horror', 'Thriller']"
3593,94,The Outsiders,10000000,25697647,25697647,15697647,2011,['Drama']
3595,96,Sparkle,10000000,24397469,24660323,14660323,2012,"['Drama', 'Music']"
3596,97,Kevin Hart: What Now?,10000000,23591043,23591043,13591043,2016,"['Comedy', 'Documentary']"
3597,98,Mud,10000000,21590086,31556959,21556959,2012,['Drama']
3598,99,Skyline,10000000,21416355,68264973,58264973,2010,"['Action', 'Sci-Fi', 'Thriller']"
3599,100,The Disaster Artist,10000000,21120616,28717667,18717667,2017,"['Biography', 'Comedy', 'Drama']"
3600,1,Blair Witch,10000000,20777061,38985577,28985577,2016,"['Horror', 'Mystery', 'Thriller']"
3602,3,Valentine,10000000,20384136,20384136,10384136,2017,['Action']
3606,7,Paranormal Activity: The Ghost Dimension,10000000,18297124,77959374,67959374,2015,"['Horror', 'Mystery', 'Thriller']"
3613,14,The Perfect Man,10000000,16535005,19535005,9535005,2011,"['Drama', 'Romance']"
3616,17,The Birth of a Nation,10000000,15861566,16891011,6891011,2016,"['Biography', 'Drama', 'History']"
3621,22,My Week with Marilyn,10000000,14597405,34240572,24240572,2011,"['Biography', 'Drama']"
3622,23,Big Eyes,10000000,14482031,27317872,17317872,2014,"['Biography', 'Crime', 'Drama']"
3627,28,The Gift,10000000,12008642,44567606,34567606,2010,['Drama']
3632,33,Drop Dead Gorgeous,10000000,10571408,10571408,571408,2015,['Comedy']
3633,34,The Best of Enemies,10000000,10205616,10205616,205616,2019,"['Biography', 'Drama', 'History']"
3638,39,Movie 43,10000000,8840453,31164747,21164747,2013,['Comedy']
3639,40,Can You Ever Forgive Me?,10000000,8803865,11752387,1752387,2018,"['Biography', 'Comedy', 'Crime']"
3641,42,MacGruber,10000000,8525600,8629895,-1370105,2010,"['Action', 'Comedy', 'Romance']"
3643,44,Bad Words,10000000,7779614,7843145,-2156855,2013,"['Comedy', 'Drama']"
3644,45,While We're Young,10000000,7582065,17503828,7503828,2014,"['Comedy', 'Drama', 'Mystery']"
3646,47,Bones,10000000,7316658,8378853,-1621147,2010,['Drama']
3647,48,Seeking a Friend for the End of the World,10000000,7078738,11766959,1766959,2012,"['Adventure', 'Comedy', 'Drama']"
3649,50,Shut In,10000000,6900335,11360665,1360665,2016,"['Drama', 'Mystery', 'Thriller']"
3650,51,Cedar Rapids,10000000,6861102,7862131,-2137869,2011,['Comedy']
3651,52,The Collection,10000000,6810754,8890094,-1109906,2012,"['Action', 'Horror', 'Thriller']"
3658,59,Danny Collins,10000000,5637066,8465845,-1534155,2015,"['Biography', 'Comedy', 'Drama']"
3660,61,Black and White,10000000,5241315,5241315,-4758685,2010,['Drama']
3662,63,On the Line,10000000,4365455,4690802,-5309198,2011,['Documentary']
3663,64,Gotti,10000000,4286367,6089100,-3910900,2018,"['Biography', 'Crime', 'Drama']"
3664,65,"Jeff, Who Lives at Home",10000000,4269426,4708127,-5291873,2011,"['Comedy', 'Drama']"
3665,66,Denial,10000000,4073448,9263940,-736060,2016,"['Biography', 'Drama']"
3666,67,The Man Who Knew Infinity,10000000,3877922,12382122,2382122,2015,"['Biography', 'Drama']"
3667,68,Max Steel,10000000,3818664,4563080,-5436920,2016,"['Action', 'Adventure', 'Family']"
3669,70,Crash,10000000,3357324,3357324,-6642676,2011,['Thriller']
3671,72,Romeo Is Bleeding,10000000,3275585,3275585,-6724415,2015,"['Biography', 'Documentary', 'Drama']"
3673,74,Rosewater,10000000,3128941,3185717,-6814283,2014,"['Biography', 'Drama']"
3674,75,The House of Mirth,10000000,3041803,5149131,-4850869,2016,['Music']
3677,78,Bucky Larson: Born to Be a Star,10000000,2529395,2529395,-7470605,2011,['Comedy']
3680,81,The Iceman,10000000,1930282,3623609,-6376391,2012,"['Biography', 'Crime', 'Drama']"
3681,82,Testament of Youth,10000000,1822250,6646669,-3353331,2014,"['Biography', 'Drama', 'History']"
3682,83,Free Fire,10000000,1799322,3793739,-6206261,2016,"['Action', 'Comedy', 'Crime']"
3683,84,A Better Life,10000000,1759252,1884251,-8115749,2011,"['Drama', 'Romance']"
3685,86,Gun Shy,10000000,1638202,1638202,-8361798,2017,"['Action', 'Adventure', 'Comedy']"
3687,88,The Joneses,10000000,1475746,3541565,-6458435,2011,"['Comedy', 'Drama']"
3689,90,Killer Joe,10000000,1291645,4659110,-5340890,2011,"['Crime', 'Drama', 'Thriller']"
3690,91,Churchill,10000000,1279681,7582196,-2417804,2017,"['Biography', 'Drama', 'History']"
3692,93,50 to 1,10000000,1069454,1069454,-8930546,2014,['Drama']
3698,99,Coriolanus,10000000,749641,2179623,-7820377,2011,"['Drama', 'Thriller', 'War']"
3699,100,Parkland,10000000,641439,1616353,-8383647,2013,"['Drama', 'History', 'Mystery']"
3710,11,"Cinco de Mayo, La Batalla",10000000,173472,173472,-9826528,2013,"['Drama', 'History', 'War']"
3711,12,Welcome to the Rileys,10000000,152857,355919,-9644081,2010,['Drama']
3712,13,Kicks,10000000,150191,150191,-9849809,2016,"['Adventure', 'Drama']"
3714,15,High School,10000000,139034,248133,-9751867,2010,['Comedy']
3715,16,Severance,10000000,137221,5950002,-4049998,2010,"['Drama', 'Sci-Fi']"
3716,17,Edmond,10000000,131719,241719,-9758281,2018,"['Comedy', 'Drama', 'History']"
3719,20,Blood Done Sign My Name,10000000,109383,109383,-9890617,2010,['Drama']
3721,22,Motherhood,10000000,93388,723388,-9276612,2017,"['Drama', 'Romance']"
3723,24,Elsa & Fred,10000000,67657,197901,-9802099,2014,"['Comedy', 'Drama', 'Romance']"
3726,27,Strangerland,10000000,17472,161097,-9838903,2015,"['Drama', 'Mystery', 'Thriller']"
3731,32,Barbecue,10000000,388,247565,-9752435,2014,['Comedy']
3732,33,The Reef,10000000,0,15037867,5037867,2010,"['Adventure', 'Drama', 'Horror']"
3734,35,American Heist,10000000,0,2341218,-7658782,2014,"['Action', 'Crime', 'Drama']"
3735,36,It's a Wonderful Afterlife,10000000,0,1642939,-8357061,2010,"['Comedy', 'Drama', 'Fantasy']"
3738,39,Plastic,10000000,0,575371,-9424629,2011,['Horror']
3739,40,Jungle Shuffle,10000000,0,360898,-9639102,2014,"['Adventure', 'Animation']"
3742,43,Good Intentions,10000000,0,0,-10000000,2010,['Comedy']
3744,45,Detention,10000000,0,0,-10000000,2010,"['Horror', 'Thriller']"
3745,46,Nurse 3D,10000000,0,0,-10000000,2013,"['Horror', 'Thriller']"
3746,47,Into the Grizzly Maze,10000000,0,0,-10000000,2015,"['Action', 'Adventure', 'Drama']"
3747,48,Friend Request,9900000,3759078,11310835,1410835,2013,['Thriller']
3748,49,Gunless,9900000,458054,458054,-9441946,2010,"['Action', 'Comedy', 'Drama']"
3750,51,Amour,9700000,6738954,36787044,27087044,2012,"['Drama', 'Romance']"
3753,54,You Only Live Twice,9500000,43100000,111600000,102100000,2014,['Documentary']
3755,56,Dangal,9500000,12391761,294654618,285154618,2016,"['Action', 'Biography', 'Drama']"
3756,57,The Runaways,9500000,3573673,5278632,-4221368,2010,"['Biography', 'Drama', 'Music']"
3758,59,Re-Kill,9500000,0,0,-9500000,2015,"['Action', 'Horror']"
3761,62,Melancholia,9400000,3030848,21817298,12417298,2011,"['Drama', 'Sci-Fi']"
3762,63,Heavy Metal,9300000,19571091,19571091,10271091,2010,"['Documentary', 'Family']"
3763,64,Jab Tak Hai Jaan,9200000,3047539,5806666,-3393334,2012,"['Drama', 'Romance']"
3764,65,Richard III,9200000,2684904,4199334,-5000666,2016,['Drama']
3765,66,Kites,9200000,1685269,17155193,7955193,2010,"['Action', 'Drama', 'Romance']"
3766,67,Red Dog,9100000,0,20927794,11827794,2011,"['Biography', 'Comedy', 'Drama']"
3770,71,The Purge: Anarchy,9000000,71562550,111534881,102534881,2014,"['Action', 'Horror', 'Sci-Fi']"
3772,73,The Strangers,9000000,52597610,83051676,74051676,2012,"['Action', 'Drama', 'Horror']"
3774,75,Ouija: Origin of Evil,9000000,35144505,81831866,72831866,2016,"['Drama', 'Horror', 'Mystery']"
3776,77,Child's Play,9000000,33244684,44196684,35196684,2019,['Horror']
3777,78,Happy Death Day 2U,9000000,28051045,64179495,55179495,2019,"['Drama', 'Horror', 'Mystery']"
3779,80,Black or White,9000000,21571189,21971021,12971021,2014,['Drama']
3782,83,The Contender,9000000,17804273,17804273,8804273,2016,"['Documentary', 'Drama', 'Sport']"
3785,86,The Edge of Seventeen,9000000,14431633,19096003,10096003,2016,"['Comedy', 'Drama']"
3786,87,Jackie,9000000,13960394,36588512,27588512,2016,"['Biography', 'Drama', 'History']"
3789,90,Glee: The 3D Concert Movie,9000000,11862398,17462398,8462398,2011,"['Documentary', 'Music']"
3790,91,Henry V,9000000,10161099,10176701,1176701,2018,"['Adventure', 'Biography', 'Drama']"
3791,92,Loving,9000000,7710234,12898064,3898064,2012,"['Drama', 'Romance']"
3800,1,Beautiful,9000000,3134509,3134509,-5865491,2011,"['Biography', 'Drama', 'Family']"
3801,2,Gracie,9000000,2956339,3922043,-5077957,2015,"['Crime', 'Drama', 'Fantasy']"
3802,3,The Sapphires,9000000,2450867,20395040,11395040,2012,"['Biography', 'Comedy', 'Drama']"
3803,4,Greater,9000000,2000093,2000093,-6999907,2016,"['Biography', 'Family', 'Sport']"
3804,5,Destroyer,9000000,1533324,3681096,-5318904,2018,"['Action', 'Crime', 'Drama']"
3811,12,Dheepan,9000000,248795,7704357,-1295643,2015,"['Crime', 'Drama']"
3813,14,All or Nothing,9000000,184255,184255,-8815745,2010,"['Action', 'Thriller', 'War']"
3818,19,Skin Trade,9000000,1242,1242,-8998758,2010,['Documentary']
3819,20,Beneath Hill 60,9000000,0,3440939,-5559061,2010,"['Drama', 'History', 'War']"
3823,24,Polisse,8900000,176988,22744132,13844132,2011,"['Crime', 'Drama']"
3828,29,Awake,8600000,14373825,32968648,24368648,2017,['Drama']
3829,30,Manchester by the Sea,8500000,47695371,77733867,69233867,2016,['Drama']
3833,34,Nightcrawler,8500000,32381218,50334418,41834418,2014,"['Crime', 'Drama', 'Thriller']"
3835,36,Dragon Ball Super: Broly,8500000,30376755,122747755,114247755,2018,"['Action', 'Adventure', 'Animation']"
3837,38,Baggage Claim,8500000,21569509,22885836,14385836,2013,['Comedy']
3838,39,Middle School: The Worst Years of My Life,8500000,20007149,23311293,14811293,2016,"['Comedy', 'Family']"
3841,42,The Namesake,8500000,13610521,20288774,11788774,2017,['Drama']
3846,47,The Rover,8500000,1109199,3180252,-5319748,2014,"['Action', 'Crime', 'Drama']"
3849,50,Posledniy bogatyr,8500000,0,30700192,22200192,2017,"['Action', 'Adventure', 'Comedy']"
3850,51,A.C.O.R.N.S.: Operation Crackdown,8500000,0,1353287,-7146713,2015,"['Animation', 'Comedy', 'Family']"
3853,54,Yeh Jawaani Hai Deewani,8300000,3827466,50827466,42527466,2013,"['Comedy', 'Drama', 'Musical']"
3854,55,Limbo,8300000,2160710,2598224,-5701776,2019,"['Drama', 'Thriller']"
3858,59,Quo Vadis?,8250000,30000000,30028513,21778513,2015,"['Drama', 'Romance']"
3866,67,Easy A,8000000,58401464,76200721,68200721,2010,"['Comedy', 'Drama', 'Romance']"
3867,68,Stand by Me,8000000,52287414,52287414,44287414,2018,['Drama']
3871,72,The Intruder,8000000,35095904,36005871,28005871,2010,['Horror']
3872,73,50/50,8000000,35016118,41334735,33334735,2011,"['Comedy', 'Drama', 'Romance']"
3874,75,A Walk in the Woods,8000000,29499394,37119358,29119358,2015,"['Adventure', 'Biography', 'Comedy']"
3875,76,Brown Sugar,8000000,27362712,28315272,20315272,2010,['Drama']
3877,78,That Awkward Moment,8000000,26068955,53068955,45068955,2014,"['Comedy', 'Romance']"
3878,79,Shutter,8000000,25928550,47782426,39782426,2012,['Thriller']
3881,82,Much Ado About Nothing,8000000,22549338,22549338,14549338,2019,['Drama']
3882,83,The Player,8000000,21706101,28876702,20876702,2017,['Sci-Fi']
3887,88,Enough Said,8000000,17550872,25621449,17621449,2013,"['Comedy', 'Drama', 'Romance']"
3889,90,New in Town,8000000,16734283,29937909,21937909,2017,"['Adventure', 'Comedy', 'Fantasy']"
3890,91,Begin Again,8000000,16170632,68838736,60838736,2013,"['Drama', 'Family']"
3892,93,See No Evil,8000000,15032800,18828036,10828036,2014,['Documentary']
3896,97,Prom,8000000,10130219,10763183,2763183,2011,"['Comedy', 'Drama', 'Family']"
3899,100,Me and Earl and the Dying Girl,8000000,6758416,9266180,1266180,2015,"['Comedy', 'Drama', 'Romance']"
3900,1,It's Kind of a Funny Story,8000000,6363628,6632950,-1367050,2010,"['Comedy', 'Drama', 'Romance']"
3904,5,Morgan,8000000,3915251,7298786,-701214,2012,"['Drama', 'Romance']"
3905,6,Anomalisa,8000000,3759286,5706168,-2293832,2015,"['Animation', 'Comedy', 'Drama']"
3907,8,Another Year,8000000,3205706,20005613,12005613,2010,"['Comedy', 'Drama']"
3912,13,Lean on Pete,8000000,1163056,2455027,-5544973,2017,"['Adventure', 'Drama']"
3913,14,Made in Dagenham,8000000,1095369,15644196,7644196,2010,"['Biography', 'Comedy', 'Drama']"
3915,16,El Chicano,8000000,700261,700261,-7299739,2018,['Drama']
3923,24,London Fields,8000000,252676,433732,-7566268,2018,"['Crime', 'Mystery', 'Thriller']"
3924,25,Restless,8000000,163753,2772511,-5227489,2011,"['Drama', 'Romance']"
3927,28,Wild Target,8000000,109338,5314194,-2685806,2010,"['Action', 'Comedy', 'Crime']"
3929,30,Wuthering Heights,8000000,100915,2721534,-5278466,2011,"['Drama', 'Romance']"
3930,31,A Street Cat Named Bob,8000000,82703,17382693,9382693,2016,"['Biography', 'Comedy', 'Drama']"
3932,33,Aloft,8000000,53086,237688,-7762312,2014,['Drama']
3935,36,Akira,8000000,19585,19585,-7980415,2021,"['Action', 'Drama', 'Mystery']"
3941,42,Swelter,8000000,0,44197,-7955803,2014,"['Action', 'Crime', 'Drama']"
3946,47,Code of Honor,8000000,0,0,-8000000,2016,"['Action', 'Crime', 'Thriller']"
3947,48,Burn Your Maps,8000000,0,0,-8000000,2016,['Adventure']
3952,53,Driving Miss Daisy,7500000,106593296,106593296,99093296,2014,"['Comedy', 'Drama']"
3966,67,Albert Nobbs,7500000,3014696,8539003,1039003,2011,"['Drama', 'Romance']"
3967,68,The Neon Demon,7500000,1333124,3559803,-3940197,2016,"['Horror', 'Thriller']"
3973,74,Black November,7500000,0,32572,-7467428,2012,"['Action', 'Crime', 'Drama']"
3974,75,Outside Bet,7500000,0,13524,-7486476,2012,['Comedy']
3975,76,Pound of Flesh,7500000,0,0,-7500000,2010,"['Crime', 'Drama', 'Thriller']"
3976,77,The Bye Bye Man,7400000,22395806,31187727,23787727,2017,"['Drama', 'Fantasy', 'Horror']"
3984,85,3,7200000,59774,295492,-6904508,2010,"['Comedy', 'Drama', 'Romance']"
3987,88,Magic Mike,7000000,113721571,170549753,163549753,2012,"['Comedy', 'Drama']"
3989,90,I Can Only Imagine,7000000,83482352,85604221,78604221,2018,"['Biography', 'Drama', 'Family']"
3990,91,Five Feet Apart,7000000,45729221,80504421,73504421,2019,"['Drama', 'Romance']"
3992,93,Jumping the Broom,7000000,37295394,38158601,31158601,2011,"['Comedy', 'Drama']"
3993,94,Live and Let Die,7000000,35400000,161800000,154800000,2015,"['Drama', 'War']"
4003,4,Gifted,7000000,24801212,36964656,29964656,2018,['Documentary']
4005,6,Kingdom Come,7000000,23247539,23393939,16393939,2015,['Documentary']
4007,8,Action Jackson,7000000,20257000,20257000,13257000,2014,"['Action', 'Thriller']"
4008,9,Breathless,7000000,19910002,19910002,12910002,2012,"['Comedy', 'Thriller']"
4010,11,Dope,7000000,17506470,18190831,11190831,2015,"['Comedy', 'Crime', 'Drama']"
4013,14,Devil's Due,7000000,15821461,36146087,29146087,2014,"['Horror', 'Mystery', 'Thriller']"
4015,16,Beyond the Lights,7000000,14618727,14618727,7618727,2014,"['Drama', 'Music', 'Romance']"
4026,27,Cyrus,7000000,7468936,10062896,3062896,2010,"['Crime', 'Horror', 'Mystery']"
4031,32,Split Second,7000000,5430822,5430822,-1569178,2010,['Drama']
4041,42,Somewhere,7000000,1785645,17023121,10023121,2010,"['Comedy', 'Drama']"
4042,43,We Need to Talk About Kevin,7000000,1738692,10765283,3765283,2011,"['Drama', 'Mystery', 'Thriller']"
4043,44,Factory Girl,7000000,1661464,1661464,-5338536,2013,"['Drama', 'Romance']"
4044,45,The Christmas Candle,7000000,1632000,1933829,-5066171,2013,"['Drama', 'Family']"
4050,51,Freeheld,7000000,546201,1732228,-5267772,2015,"['Biography', 'Drama', 'Romance']"
4051,52,Dom Hemingway,7000000,523511,1857458,-5142542,2013,"['Comedy', 'Crime', 'Drama']"
4052,53,The Extra Man,7000000,453377,492108,-6507892,2010,['Comedy']
4053,54,Hesher,7000000,382946,382946,-6617054,2010,"['Comedy', 'Crime', 'Drama']"
4055,56,Gerry,7000000,254683,719699,-6280301,2011,['Biography']
4062,63,Oddball,7000000,0,10237229,3237229,2015,"['Adventure', 'Family']"
4063,64,Z Storm,7000000,0,2053330,-4946670,2014,"['Action', 'Crime']"
4064,65,Geroy,7000000,0,1545121,-5454879,2019,['Action']
4065,66,Twixt,7000000,0,1268346,-5731654,2011,"['Comedy', 'Fantasy', 'Horror']"
4066,67,Criminal Activities,7000000,0,386744,-6613256,2015,"['Crime', 'Drama', 'Thriller']"
4072,73,House at the End of the Street,6900000,31611916,44103982,37203982,2012,"['Drama', 'Horror', 'Thriller']"
4074,75,Two Lovers and a Bear,6840000,0,22273,-6817727,2016,"['Adventure', 'Drama', 'Romance']"
4075,76,Incendies,6800000,6857096,16038343,9238343,2010,"['Drama', 'Mystery', 'War']"
4083,84,Annabelle,6500000,84273813,256862920,250362920,2014,"['Horror', 'Mystery', 'Thriller']"
4089,90,The Adventures of Huck Finn,6500000,24103594,24103594,17603594,2012,"['Adventure', 'Family']"
4094,95,Same Kind of Different as Me,6500000,6423605,6423605,-76395,2017,"['Biography', 'Drama']"
4096,97,Shame,6500000,4002293,20412841,13912841,2011,['Drama']
4098,99,The East,6500000,2274649,3027956,-3472044,2013,"['Adventure', 'Drama', 'Thriller']"
4100,1,The Messenger,6500000,1109660,1744952,-4755048,2012,['Drama']
4102,3,Aberdeen,6500000,64148,64148,-6435852,2014,['Family']
4103,4,Tracker,6500000,0,3149,-6496851,2010,"['Action', 'Adventure', 'Drama']"
4106,7,Control,6400000,871577,8902141,2502141,2017,"['Action', 'Crime', 'Drama']"
4117,18,Ordinary People,6000000,52302978,52302978,46302978,2016,['Drama']
4118,19,Breaking In,6000000,46840590,51411620,45411620,2018,"['Action', 'Crime', 'Drama']"
4119,20,West Side Story,6000000,43700000,43700000,37700000,2020,"['Crime', 'Drama', 'Musical']"
4132,33,Unplanned,6000000,18107621,18107621,12107621,2019,"['Biography', 'Drama']"
4135,36,The Prodigy,6000000,14856291,19789712,13789712,2019,"['Horror', 'Thriller']"
4136,37,The Possession of Hannah Grace,6000000,14836174,42785387,36785387,2018,"['Horror', 'Mystery', 'Thriller']"
4145,46,The Words,6000000,11494838,16369708,10369708,2012,"['Drama', 'Mystery', 'Romance']"
4146,47,The Lady in the Van,6000000,10021175,42320503,36320503,2015,"['Biography', 'Comedy', 'Drama']"
4147,48,Bernie,6000000,9204489,10106975,4106975,2011,"['Biography', 'Comedy', 'Crime']"
4152,53,Casa de mi Padre,6000000,5909483,8446952,2446952,2012,"['Comedy', 'Western']"
4153,54,The Guard,6000000,5359774,21197454,15197454,2011,"['Comedy', 'Crime', 'Thriller']"
4157,58,Little Voice,6000000,4595000,21787233,15787233,2018,"['Horror', 'Thriller']"
4160,61,Wish I Was Here,6000000,3591299,6591365,591365,2014,"['Comedy', 'Drama']"
4161,62,Venus,6000000,3347411,7818479,1818479,2016,['Documentary']
4162,63,Veronica Mars,6000000,3322127,3485383,-2514617,2014,"['Crime', 'Drama', 'Mystery']"
4165,66,Shattered Glass,6000000,2207975,3456602,-2543398,2014,['Drama']
4169,70,Snow Flower and the Secret Fan,6000000,1348205,11348205,5348205,2011,"['Drama', 'History']"
4170,71,Mandy,6000000,1214525,1427656,-4572344,2016,"['Drama', 'Thriller']"
4175,76,The 5th Quarter,6000000,408159,408159,-5591841,2010,"['Biography', 'Drama', 'Sport']"
4182,83,Deadfall,6000000,66351,1673635,-4326365,2012,"['Crime', 'Drama', 'Thriller']"
4183,84,Julia,6000000,65108,1365108,-4634892,2014,"['Horror', 'Thriller']"
4186,87,Song One,6000000,32251,437089,-5562911,2014,"['Drama', 'Music']"
4187,88,Lake of Fire,6000000,25317,26007,-5973993,2018,"['Drama', 'Family', 'Romance']"
4190,91,Icarus,6000000,0,0,-6000000,2017,"['Documentary', 'Sport', 'Thriller']"
4193,94,Freaky Deaky,6000000,0,0,-6000000,2012,"['Comedy', 'Crime', 'Thriller']"
4194,95,The Hit List,6000000,0,0,-6000000,2011,"['Action', 'Thriller']"
4196,97,Emma,5900000,22231658,37831658,31931658,2016,['Thriller']
4199,100,The Train,5800000,6800000,6800000,1000000,2011,['Drama']
4202,3,Trade of Innocents,5800000,15091,15091,-5784909,2012,"['Drama', 'Thriller']"
4210,11,Standing Ovation,5600000,531806,531806,-5068194,2010,['Musical']
4211,12,Khiladi 786,5600000,385422,14683763,9083763,2012,"['Action', 'Comedy']"
4216,17,Shine,5500000,35811509,36672493,31172493,2017,"['Drama', 'Music']"
4217,18,Don Jon,5500000,24477704,41268579,35768579,2013,"['Comedy', 'Drama', 'Romance']"
4219,20,Hell Fest,5500000,11107431,18119231,12619231,2018,['Horror']
4222,23,Iris,5500000,5580479,5580479,80479,2011,"['Drama', 'Family', 'History']"
4225,26,Wonderland,5500000,1060512,1060512,-4439488,2011,"['Fantasy', 'Horror', 'Sci-Fi']"
4228,29,Le Havre,5500000,611709,13480196,7980196,2011,"['Comedy', 'Drama']"
4230,31,Salvation Boulevard,5500000,28468,28468,-5471532,2011,"['Action', 'Comedy', 'Drama']"
4231,32,R100,5500000,24956,24956,-5475044,2013,"['Comedy', 'Drama']"
4232,33,Miss Julie,5500000,0,863895,-4636105,2013,"['Drama', 'Romance']"
4233,34,Animals,5500000,0,0,-5500000,2012,"['Drama', 'Fantasy']"
4234,35,Irreversible,5400000,792200,8133256,2733256,2014,['Drama']
4237,38,Grabbers,5300000,0,440821,-4859179,2012,"['Comedy', 'Horror', 'Sci-Fi']"
4243,44,Wilson,5200000,2000000,2000000,-3200000,2017,"['Comedy', 'Drama']"
4245,46,Dum Maaro Dum,5200000,564489,11633427,6433427,2011,"['Action', 'Crime', 'Drama']"
4248,49,Get Out,5000000,176040665,255367951,250367951,2017,"['Horror', 'Mystery', 'Thriller']"
4249,50,Split,5000000,138141585,278964806,273964806,2016,"['Comedy', 'Romance', 'Sport']"
4250,51,Paranormal Activity 3,5000000,104028807,207039844,202039844,2011,"['Horror', 'Mystery', 'Thriller']"
4253,54,10 Cloverfield Lane,5000000,72082999,108286422,103286422,2016,"['Drama', 'Horror', 'Mystery']"
4254,55,Lights Out,5000000,67268835,148806510,143806510,2010,['Drama']
4255,56,The Visit,5000000,65206105,98677816,93677816,2010,"['Comedy', 'Drama', 'Romance']"
4257,58,Happy Death Day,5000000,55683845,125010260,120010260,2017,"['Horror', 'Mystery', 'Thriller']"
4258,59,Paranormal Activity 4,5000000,53900335,142817992,137817992,2012,"['Horror', 'Mystery', 'Thriller']"
4259,60,Ouija,5000000,50856010,103300632,98300632,2014,"['Horror', 'Mystery', 'Thriller']"
4263,64,The Big Sick,5000000,42872467,53972860,48972860,2017,"['Comedy', 'Drama', 'Romance']"
4268,69,Monster,5000000,34469210,64240813,59240813,2010,"['Action', 'Adventure', 'Comedy']"
4269,70,Paranormal Activity: The Marked Ones,5000000,32462372,90904854,85904854,2014,"['Horror', 'Mystery', 'Thriller']"
4271,72,Oculus,5000000,27695246,44115496,39115496,2013,"['Horror', 'Mystery']"
4272,73,Dallas Buyers Club,5000000,27298285,60611845,55611845,2013,"['Biography', 'Drama']"
4273,74,No Escape,5000000,27288872,42844516,37844516,2015,"['Action', 'Thriller']"
4275,76,The Lazarus Effect,5000000,25801570,38359310,33359310,2015,"['Horror', 'Mystery', 'Sci-Fi']"
4277,78,Our Idiot Brother,5000000,24814830,25861249,20861249,2011,"['Comedy', 'Drama']"
4278,79,The Strangers: Prey at Night,5000000,24431472,29960051,24960051,2018,['Horror']
4281,82,Billy Elliot,5000000,21995263,109253745,104253745,2014,"['Comedy', 'Drama', 'Music']"
4282,83,The Way Way Back,5000000,21502690,26853810,21853810,2013,"['Comedy', 'Drama']"
4283,84,"As Above, So Below",5000000,21222315,41824066,36824066,2012,['Documentary']
4285,86,The Apostle,5000000,20733485,21277770,16277770,2012,"['Animation', 'Horror']"
4289,90,Race,5000000,19115191,23745772,18745772,2010,"['Biography', 'Documentary', 'History']"
4291,92,Still Alice,5000000,18656400,41699612,36699612,2014,['Drama']
4293,94,Apollo 18,5000000,17686929,26517819,21517819,2011,"['Horror', 'Mystery', 'Sci-Fi']"
4294,95,"Paul, Apostle of Christ",5000000,17547999,25529498,20529498,2018,"['Adventure', 'Biography', 'Drama']"
4295,96,Addicted,5000000,17390770,17499242,12499242,2014,"['Drama', 'Thriller']"
4300,1,Nighthawks,5000000,14600000,19600000,14600000,2012,['Drama']
4302,3,Spring Breakers,5000000,14124286,31149251,26149251,2012,"['Comedy', 'Crime', 'Drama']"
4303,4,It Comes at Night,5000000,13985117,19720203,14720203,2017,"['Horror', 'Mystery']"
4310,11,Diner,5000000,12592907,12592907,7592907,2019,['Crime']
4311,12,Before I Fall,5000000,12241072,18945682,13945682,2017,"['Drama', 'Fantasy', 'Mystery']"
4314,15,Fifty Shades of Black,5000000,11686940,22113075,17113075,2016,['Comedy']
4320,21,The Belko Experiment,5000000,10166820,11792942,6792942,2016,"['Horror', 'Thriller']"
4321,22,The Perfect Match,5000000,9669521,10182050,5182050,2013,"['Biography', 'Documentary', 'Family']"
4327,28,The Forsaken,5000000,6755271,6755271,1755271,2015,"['Drama', 'Horror', 'Thriller']"
4328,29,Fahrenheit 11/9,5000000,6352306,6653715,1653715,2018,['Documentary']
4330,31,Sea Rex 3D: Journey to a Prehistoric World,5000000,6096582,16515203,11515203,2010,['Documentary']
4337,38,90 Minutes in Heaven,5000000,4816142,4816142,-183858,2015,['Drama']
4338,39,Incarnate,5000000,4799774,9371036,4371036,2016,"['Horror', 'Thriller']"
4344,45,Table 19,5000000,3614896,4620399,-379601,2017,"['Comedy', 'Drama', 'Romance']"
4345,46,Green Room,5000000,3220371,3807503,-1192497,2015,"['Horror', 'Music', 'Thriller']"
4346,47,Thoroughbreds,5000000,3072605,3187302,-1812698,2017,"['Comedy', 'Crime', 'Drama']"
4348,49,The Other Side of the Door,5000000,3000342,12905107,7905107,2014,['Drama']
4349,50,Everything Must Go,5000000,2712131,2821010,-2178990,2010,"['Comedy', 'Drama']"
4350,51,Kill the Messenger,5000000,2450846,6656705,1656705,2014,"['Biography', 'Crime', 'Drama']"
4351,52,Rabbit Hole,5000000,2229058,6205034,1205034,2010,['Drama']
4352,53,Jem and the Holograms,5000000,2184640,2368937,-2631063,2015,"['Adventure', 'Drama', 'Family']"
4353,54,Paterson,5000000,2141423,10727536,5727536,2016,"['Comedy', 'Drama', 'Romance']"
4359,60,Atlas Shrugged: Who Is John Galt?,5000000,851690,851690,-4148310,2014,"['Drama', 'Mystery', 'Sci-Fi']"
4363,64,Ain't Them Bodies Saints,5000000,391611,1075009,-3924991,2013,"['Crime', 'Drama', 'Romance']"
4370,71,Cop Car,5000000,134552,143658,-4856342,2015,"['Crime', 'Thriller']"
4375,76,Stuck,5000000,67505,67505,-4932495,2012,"['Comedy', 'Drama']"
4377,78,Rudderless,5000000,56001,567219,-4432781,2014,"['Comedy', 'Drama', 'Music']"
4379,80,Grace,5000000,8297,8297,-4991703,2011,"['Crime', 'Drama', 'Horror']"
4380,81,Area 51,5000000,7556,7556,-4992444,2015,"['Horror', 'Sci-Fi', 'Thriller']"
4383,84,The Cottage,5000000,0,1504960,-3495040,2012,"['Drama', 'Horror', 'Thriller']"
4384,85,Dying of the Light,5000000,0,74639,-4925361,2014,"['Drama', 'Thriller']"
4385,86,Yoga Hosers,5000000,0,22958,-4977042,2016,"['Action', 'Comedy', 'Fantasy']"
4389,90,Reach Me,5000000,0,0,-5000000,2014,"['Comedy', 'Crime', 'Drama']"
4390,91,Henry & Me,5000000,0,0,-5000000,2014,"['Animation', 'Family']"
4391,92,Born of War,5000000,0,0,-5000000,2014,"['Action', 'Drama', 'Thriller']"
4392,93,Let's Kill Ward's Wife,5000000,0,0,-5000000,2014,"['Comedy', 'Crime']"
4395,96,Should've Been Romeo,5000000,0,0,-5000000,2012,"['Comedy', 'Drama']"
4396,97,Aztec Warrior,5000000,0,0,-5000000,2016,"['Action', 'Comedy']"
4398,99,The Hatching,5000000,0,0,-5000000,2017,"['Action', 'Adventure', 'Comedy']"
4399,100,Running Forever,5000000,0,0,-5000000,2015,['Family']
4400,1,Mommy,4900000,3498695,17536004,12636004,2014,['Drama']
4403,4,The Awakening,4900000,95933,6924321,2024321,2010,"['Horror', 'Thriller']"
4406,7,Hostel,4800000,47326473,82241110,77441110,2011,"['Action', 'Crime', 'Drama']"
4407,8,Only God Forgives,4800000,775849,4494560,-305440,2013,"['Crime', 'Drama']"
4408,9,Take Shelter,4750000,1728953,4972016,222016,2011,"['Drama', 'Horror', 'Thriller']"
4411,12,Lady in White,4700000,1705139,1705139,-2994861,2018,"['Comedy', 'Drama']"
4413,14,Without Men,4700000,0,0,-4700000,2011,['Comedy']
4414,15,Treading Water,4700000,0,0,-4700000,2013,"['Comedy', 'Drama']"
4417,18,Barfi,4600000,2804874,36751984,32151984,2013,"['Comedy', 'Romance']"
4422,23,Out of the Blue,4600000,728,731767,-3868233,2013,"['Comedy', 'Drama']"
4427,28,Secrets & Lies,4500000,13417292,13417292,8917292,2018,"['Drama', 'Romance']"
4430,31,Moby Dick,4500000,10400000,10400000,5900000,2011,['Action']
4431,32,The Lobster,4500000,9196278,18019834,13519834,2015,"['Comedy', 'Drama', 'Romance']"
4432,33,Bound,4500000,3802260,7011317,2511317,2020,"['Action', 'Drama']"
4437,38,Salvador,4500000,1500000,1500000,-3000000,2016,['Drama']
4443,44,Life During Wartime,4500000,281447,281447,-4218553,2014,"['Documentary', 'History']"
4445,46,Blackthorn,4500000,200558,1217307,-3282693,2011,"['Action', 'Adventure', 'Western']"
4446,47,Maggie,4500000,187112,1027760,-3472240,2015,"['Drama', 'Horror']"
4452,53,The Sweeney,4500000,26345,8000366,3500366,2012,"['Action', 'Crime', 'Drama']"
4453,54,Falcon Rising,4500000,11774,11774,-4488226,2014,"['Action', 'Adventure']"
4454,55,Hansel & Gretel Get Baked,4500000,0,0,-4500000,2013,"['Comedy', 'Horror']"
4455,56,Fugly,4500000,0,0,-4500000,2014,"['Drama', 'Thriller']"
4456,57,Zipper,4500000,0,0,-4500000,2015,"['Drama', 'Thriller']"
4457,58,The Final Girls,4500000,0,0,-4500000,2015,"['Comedy', 'Drama', 'Fantasy']"
4458,59,Daisy Winters,4500000,0,0,-4500000,2017,['Drama']
4463,64,Anna,4357373,0,1200000,-3157373,2013,"['Drama', 'Mystery', 'Sci-Fi']"
4468,69,Night of the Living Dead,4200000,5835247,5835247,1635247,2014,['Horror']
4470,71,Animal Kingdom,4200000,1044039,8078683,3878683,2010,"['Crime', 'Drama']"
4472,73,Cargo,4200000,0,313230,-3886770,2011,['Drama']
4480,81,The Boy Next Door,4000000,36006065,53401938,49401938,2015,"['Horror', 'Thriller']"
4484,85,Boyhood,4000000,25379975,57273049,53273049,2014,['Drama']
4485,86,Exodus,4000000,21750000,21750000,17750000,2017,['Documentary']
4486,87,The Kids Are All Right,4000000,20811365,36275469,32275469,2010,"['Comedy', 'Drama', 'Romance']"
4488,89,A Haunted House 2,4000000,17329487,21206861,17206861,2014,"['Comedy', 'Fantasy']"
4489,90,The Last Exorcism Part II,4000000,15179303,25448707,21448707,2013,"['Drama', 'Horror', 'Thriller']"
4494,95,Saving Grace,4000000,12178602,27786849,23786849,2010,"['Crime', 'Drama', 'Horror']"
4497,98,The Darkness,4000000,10753574,10898293,6898293,2016,"['Horror', 'Thriller']"
4499,100,The Wash,4000000,10097096,10097096,6097096,2011,['Thriller']
4501,2,The Visitor,4000000,9427026,19174817,15174817,2011,"['Drama', 'Romance']"
4507,8,Bug,4000000,7006708,8302995,4302995,2017,"['Drama', 'Mystery', 'Thriller']"
4517,18,Samsara,4000000,2672413,5966671,1966671,2011,"['Documentary', 'Music']"
4519,20,The Art of Getting By,4000000,1430241,1989035,-2010965,2011,"['Drama', 'Romance']"
4521,22,Red State,4000000,1065429,1983596,-2016404,2011,"['Action', 'Crime', 'Horror']"
4524,25,Holy Motors,4000000,641054,4230426,230426,2012,"['Drama', 'Fantasy']"
4525,26,The Signal,4000000,600896,2665322,-1334678,2014,"['Drama', 'Mystery', 'Sci-Fi']"
4528,29,The Face of Love,4000000,385069,1158877,-2841123,2013,"['Drama', 'Mystery', 'Romance']"
4529,30,Joe,4000000,373375,373375,-3626625,2013,"['Crime', 'Drama']"
4534,35,Late Night,4000000,246305,246305,-3753695,2019,"['Comedy', 'Drama']"
4537,38,Desert Dancer,4000000,155271,596335,-3403665,2014,"['Biography', 'Drama', 'Music']"
4540,41,Manglehorn,4000000,132270,797439,-3202561,2014,['Drama']
4542,43,Trust,4000000,120016,120016,-3879984,2010,"['Crime', 'Drama', 'Thriller']"
4546,47,Stake Land,4000000,33245,679482,-3320518,2010,"['Drama', 'Horror', 'Sci-Fi']"
4548,49,Sonny,4000000,17639,17639,-3982361,2010,['Drama']
4550,51,13 Sins,4000000,9134,47552,-3952448,2014,"['Horror', 'Thriller']"
4551,52,Another Happy Day,4000000,9120,978527,-3021473,2011,"['Comedy', 'Drama']"
4552,53,Inescapable,4000000,4327,4327,-3995673,2012,"['Action', 'Drama', 'Mystery']"
4555,56,A Lonely Place to Die,4000000,0,442550,-3557450,2011,"['Adventure', 'Crime', 'Thriller']"
4556,57,Nothing,4000000,0,63180,-3936820,2019,['Sci-Fi']
4561,62,Replicas,4000000,0,0,-4000000,2018,"['Drama', 'Sci-Fi', 'Thriller']"
4563,64,The Veil,4000000,0,0,-4000000,2017,"['Action', 'Adventure', 'Sci-Fi']"
4564,65,The Perfect Wave,4000000,0,0,-4000000,2014,"['Adventure', 'Biography', 'Drama']"
4566,67,Chain of Command,4000000,0,0,-4000000,2015,"['Action', 'Thriller']"
4568,69,A Man for All Seasons,3900000,28350000,28350000,24450000,2014,"['Biography', 'Documentary', 'Family']"
4570,71,Network,3800000,23689877,23689877,19889877,2019,"['Drama', 'Thriller']"
4576,77,Annie Get Your Gun,3768785,8000000,8000000,4231215,2014,['Crime']
4578,79,Four Lions,3750000,310007,2436111,-1313889,2010,"['Comedy', 'Crime', 'Drama']"
4590,91,Truth or Dare,3500000,41411015,95127344,91627344,2013,"['Horror', 'Romance', 'Thriller']"
4592,93,Friday,3500000,27467564,27936778,24436778,2012,['Family']
4593,94,The Witch,3500000,25138705,40454520,36954520,2015,"['Horror', 'Mystery']"
4594,95,Winchester,3500000,25091816,44378040,40878040,2018,"['Biography', 'Drama', 'Fantasy']"
4596,97,Dark Skies,3500000,17418667,27704111,24204111,2013,"['Horror', 'Sci-Fi', 'Thriller']"
4597,98,Forever My Girl,3500000,16376066,16376066,12876066,2018,"['Drama', 'Music', 'Romance']"
4601,2,Frenzy,3500000,12600000,12600000,9100000,2015,['Thriller']
4604,5,She's the One,3500000,9482579,13795053,10295053,2013,"['Drama', 'Romance']"
4610,11,First Reformed,3500000,3448256,3874772,374772,2017,"['Drama', 'Mystery', 'Thriller']"
4612,13,Believe,3500000,890303,890303,-2609697,2018,['Documentary']
4614,15,American Honey,3500000,663247,2611750,-888250,2016,"['Adventure', 'Drama', 'Romance']"
4615,16,The Bronze,3500000,615816,615816,-2884184,2015,"['Comedy', 'Drama', 'Sport']"
4618,19,The Masked Saint,3500000,182695,182695,-3317305,2016,"['Action', 'Biography', 'Crime']"
4621,22,Time to Choose,3500000,29233,29233,-3470767,2015,['Documentary']
4624,25,The Kick,3500000,0,40622,-3459378,2011,"['Action', 'Sport']"
4626,27,The Secret,3500000,0,0,-3500000,2013,['Documentary']
4631,32,Dawn Patrol,3500000,0,0,-3500000,2014,"['Drama', 'Thriller']"
4633,34,Lords of London,3440000,0,0,-3440000,2014,"['Crime', 'Mystery', 'Thriller']"
4636,37,Margin Call,3400000,5353586,20433227,17033227,2011,"['Drama', 'Thriller']"
4637,38,Choke,3400000,2926565,4124277,724277,2011,"['Action', 'Drama', 'Romance']"
4639,40,August,3400000,12636,12636,-3387364,2011,"['Drama', 'Romance']"
4642,43,Whiplash,3300000,13092006,38969037,35669037,2014,"['Drama', 'Music']"
4643,44,Bella,3300000,8093373,12405473,9105473,2018,"['Drama', 'Family']"
4647,48,The Opposite Sex,3300000,0,50206,-3249794,2014,['Comedy']
4652,53,Rosemary's Baby,3200000,33395426,33395426,30195426,2015,['Comedy']
4653,54,Sorry to Bother You,3200000,17493096,18285560,15085560,2018,"['Comedy', 'Fantasy', 'Sci-Fi']"
4656,57,Beginners,3200000,5790894,14314407,11114407,2010,"['Comedy', 'Drama', 'Romance']"
4657,58,The Meddler,3200000,4267219,5526942,2326942,2015,"['Comedy', 'Drama', 'Romance']"
4658,59,Adam,3200000,2283291,2834485,-365515,2019,['Drama']
4659,60,Feast,3200000,56131,690872,-2509128,2014,['Horror']
4662,63,Antiviral,3100000,0,123407,-2976593,2012,"['Horror', 'Sci-Fi', 'Thriller']"
4664,65,Paranormal Activity 2,3000000,84752907,177512032,174512032,2010,['Horror']
4665,66,War Room,3000000,67790117,73975239,70975239,2015,['Drama']
4666,67,The Purge,3000000,64473115,91266581,88266581,2013,"['Horror', 'Thriller']"
4668,69,Sinister,3000000,48086903,87727807,84727807,2012,"['Horror', 'Mystery', 'Thriller']"
4671,72,Coming Home,3000000,32653000,32653000,29653000,2012,['Documentary']
4688,89,Upgrade,3000000,11977130,16553285,13553285,2018,"['Action', 'Sci-Fi', 'Thriller']"
4696,97,Red River,3000000,9012000,9012000,6012000,2011,['Horror']
4698,99,Before Midnight,3000000,8110621,23251930,20251930,2013,"['Drama', 'Romance']"
4700,1,The Collector,3000000,7712114,10473836,7473836,2012,"['Action', 'Comedy']"
4702,3,Let There Be Light,3000000,7233471,7241309,4241309,2012,['Documentary']
4707,8,Water,3000000,5529144,11322573,8322573,2014,"['Crime', 'Thriller']"
4709,10,Swiss Army Man,3000000,4210454,5837111,2837111,2016,"['Adventure', 'Comedy', 'Drama']"
4712,13,Kama Sutra,3000000,4109095,4109095,1109095,2013,['Romance']
4713,14,Frances Ha,3000000,4067398,11262769,8262769,2012,"['Comedy', 'Drama', 'Romance']"
4714,15,Please Give,3000000,4033574,4570178,1570178,2010,"['Comedy', 'Drama']"
4720,21,Compadres,3000000,3127773,7445044,4445044,2016,"['Action', 'Comedy', 'Crime']"
4724,25,Letters to God,3000000,2848587,3237452,237452,2010,"['Drama', 'Family']"
4725,26,Happiness,3000000,2746453,5746453,2746453,2013,"['Documentary', 'Drama', 'Family']"
4727,28,Tusk,3000000,1821983,1887554,-1112446,2014,"['Comedy', 'Drama', 'Horror']"
4728,29,The Wall,3000000,1803064,4495262,1495262,2010,['Documentary']
4730,31,Damsels in Distress,3000000,1007535,1324299,-1675701,2011,"['Comedy', 'Drama', 'Romance']"
4731,32,Oldboy,3000000,707391,6239723,3239723,2013,"['Action', 'Drama', 'Mystery']"
4732,33,Hobo with a Shotgun,3000000,703372,834953,-2165047,2011,"['Action', 'Comedy', 'Horror']"
4733,34,The D Train,3000000,669688,772366,-2227634,2015,"['Comedy', 'Drama']"
4734,35,Bachelorette,3000000,446770,12577401,9577401,2012,"['Comedy', 'Romance']"
4737,38,Creature,3000000,331000,331000,-2669000,2011,['Horror']
4738,39,The Bounce Back,3000000,321910,421404,-2578596,2016,"['Comedy', 'Romance']"
4739,40,Freeway,3000000,295493,295493,-2704507,2011,['Drama']
4743,44,Tim and Eric's Billion Dollar Movie,3000000,201436,223652,-2776348,2012,['Comedy']
4744,45,Holly,3000000,163069,163069,-2836931,2015,"['Action', 'Crime', 'Thriller']"
4748,49,Fort McCoy,3000000,78948,78948,-2921052,2011,"['Drama', 'History', 'War']"
4751,52,Before We Go,3000000,37151,483938,-2516062,2014,"['Comedy', 'Drama', 'Romance']"
4752,53,The Divide,3000000,18000,156362,-2843638,2011,"['Drama', 'Horror', 'Sci-Fi']"
4755,56,Demonic,3000000,0,4668109,1668109,2015,"['Horror', 'Thriller']"
4757,58,They Came Together,3000000,0,82780,-2917220,2014,"['Comedy', 'Romance']"
4758,59,Open Road,3000000,0,47469,-2952531,2013,"['Action', 'Drama', 'Thriller']"
4760,61,Barry Munday,3000000,0,0,-3000000,2010,"['Comedy', 'Drama', 'Romance']"
4761,62,The Deported,3000000,0,0,-3000000,2019,['Documentary']
4764,65,AWOL-72,3000000,0,0,-3000000,2015,"['Action', 'Thriller']"
4766,67,Enter the Dangerous Mind,3000000,0,0,-3000000,2013,['Thriller']
4767,68,Something Wicked,3000000,0,0,-3000000,2014,"['Drama', 'Horror', 'Mystery']"
4768,69,Point Blank,3000000,0,0,-3000000,2010,"['Action', 'Crime', 'Drama']"
4771,72,Amnesiac,3000000,0,0,-3000000,2013,"['Drama', 'Horror', 'Thriller']"
4772,73,Unnatural,3000000,0,0,-3000000,2015,"['Action', 'Horror', 'Sci-Fi']"
4773,74,Close Range,3000000,0,0,-3000000,2015,"['Action', 'Crime']"
4779,80,Freakonomics,2900000,101270,172867,-2727133,2010,['Documentary']
4780,81,Griff the Invisible,2900000,20778,25935,-2874065,2010,"['Comedy', 'Drama', 'Romance']"
4792,93,Indivisible,2700000,3511417,3588305,888305,2017,['Documentary']
4794,95,Sardaar Ji,2700000,0,8200000,5500000,2015,"['Comedy', 'Fantasy', 'Horror']"
4797,98,Diane,2660000,0,0,-2660000,2017,"['Crime', 'Drama', 'Horror']"
4802,3,Ida,2600000,3827060,15298355,12698355,2013,['Drama']
4809,10,"Fat, Sick & Nearly Dead",2600000,0,0,-2600000,2010,['Documentary']
4811,12,A Haunted House,2500000,40041683,59922558,57422558,2013,"['Comedy', 'Fantasy']"
4813,14,Kevin Hart: Let Me Explain,2500000,32244051,32327255,29827255,2013,"['Comedy', 'Documentary']"
4816,17,Halloween II,2500000,25533818,25533818,23033818,2010,['Horror']
4821,22,The Spectacular Now,2500000,6852971,6916951,4416951,2013,"['Comedy', 'Drama', 'Romance']"
4823,24,Before Sunrise,2500000,5274005,5690220,3190220,2014,['Drama']
4824,25,Hunt for the Wilderpeople,2500000,5205471,23845533,21345533,2016,"['Adventure', 'Comedy', 'Drama']"
4825,26,Robot & Frank,2500000,3317468,4934356,2434356,2012,"['Comedy', 'Crime', 'Drama']"
4830,31,The Lost Medallion: The Adventures of Billy Stone,2500000,549632,549632,-1950368,2013,"['Adventure', 'Family', 'Fantasy']"
4833,34,Super,2500000,327716,593933,-1906067,2010,"['Action', 'Comedy', 'Drama']"
4834,35,Fuel,2500000,174255,174255,-2325745,2018,"['Documentary', 'Sport']"
4837,38,8: The Mormon Proposition,2500000,100280,100280,-2399720,2010,['Documentary']
4840,41,Underdogs,2500000,35017,1392649,-1107351,2018,"['Documentary', 'Sport']"
4842,43,The Calling,2500000,0,0,-2500000,2014,"['Drama', 'Thriller']"
4843,44,Alien Uprising,2500000,0,0,-2500000,2012,"['Comedy', 'Horror', 'Sci-Fi']"
4844,45,Christmas Mail,2500000,0,0,-2500000,2010,"['Comedy', 'Drama', 'Family']"
4845,46,Stung,2500000,0,0,-2500000,2015,"['Action', 'Adventure', 'Comedy']"
4847,48,8 Days,2500000,0,0,-2500000,2014,"['Drama', 'Thriller']"
4848,49,Antibirth,2500000,0,0,-2500000,2016,['Horror']
4849,50,The Rise of the Krays,2500000,0,0,-2500000,2015,"['Crime', 'Drama']"
4856,57,Always Woodstock,2400000,0,0,-2400000,2014,"['Comedy', 'Music', 'Romance']"
4859,60,Do You Believe?,2300000,12985600,14304931,12004931,2015,['Drama']
4862,63,Frontera,2300000,59696,59696,-2240304,2010,"['Action', 'Drama', 'Thriller']"
4863,64,Redemption Road,2300000,29384,29384,-2270616,2010,['Drama']
4865,66,Eden,2300000,0,0,-2300000,2020,['Drama']
4868,69,Fantasia,2280000,83320000,83320000,81040000,2014,['Drama']
4877,78,The Best Years of Our Lives,2100000,23600000,23600000,21500000,2013,['Comedy']
4878,79,Bully,2100000,881824,1381824,-718176,2011,['Documentary']
4880,81,Mi America,2100000,3330,3330,-2096670,2015,"['Crime', 'Drama']"
4882,83,Infected,2100000,0,0,-2100000,2013,"['Action', 'Horror', 'Sci-Fi']"
4884,85,The Timber,2100000,0,0,-2100000,2015,"['Action', 'Adventure', 'Drama']"
4885,86,Sharkskin,2100000,0,0,-2100000,2015,"['Comedy', 'Drama', 'Mystery']"
4886,87,Courageous,2000000,34522221,35185884,33185884,2011,['Drama']
4891,92,Sleeper,2000000,18344729,18344729,16344729,2012,"['Action', 'Horror']"
4893,94,It Follows,2000000,14674077,23250755,21250755,2014,"['Horror', 'Mystery']"
4894,95,Eighth Grade,2000000,13539710,14341016,12341016,2018,"['Comedy', 'Drama']"
4896,97,Silent House,2000000,12739737,16610760,14610760,2011,"['Drama', 'Horror', 'Mystery']"
4899,100,Hardcore Henry,2000000,9252038,17187434,15187434,2015,"['Action', 'Adventure', 'Sci-Fi']"
4903,4,The Hustler,2000000,7600000,7600000,5600000,2016,['Documentary']
4906,7,Smoke Signals,2000000,6719300,7756617,5756617,2019,['Documentary']
4907,8,Winter's Bone,2000000,6531503,16131551,14131551,2010,"['Drama', 'Mystery']"
4908,9,Meet the Mormons,2000000,6047363,6049171,4049171,2014,['Documentary']
4910,11,The Florida Project,2000000,5904366,11295324,9295324,2017,['Drama']
4911,12,All Saints,2000000,5802208,5941994,3941994,2017,['Drama']
4914,15,Thirteen,2000000,4601043,9505996,7505996,2014,['Drama']
4916,17,Inside Job,2000000,4311834,7799257,5799257,2010,"['Crime', 'Documentary']"
4919,20,We Are Your Friends,2000000,3591417,10153415,8153415,2015,"['Drama', 'Music', 'Romance']"
4922,23,Captive,2000000,2583301,2791973,791973,2012,"['Drama', 'Thriller']"
4924,25,Hearts Beat Loud,2000000,2386254,2420962,420962,2018,"['Comedy', 'Drama', 'Music']"
4925,26,The Resurrection of Gavin Stone,2000000,2303792,2303792,303792,2016,"['Comedy', 'Drama', 'Family']"
4929,30,Nemesis,2000000,2001124,2001124,1124,2010,['Drama']
4934,35,The Diary of a Teenage Girl,2000000,1477002,2279959,279959,2015,"['Comedy', 'Drama', 'Romance']"
4936,37,Locke,2000000,1370646,2088390,88390,2013,['Drama']
4937,38,Get Real,2000000,1152411,1152411,-847589,2019,['Drama']
4938,39,In the Shadow of the Moon,2000000,1134358,2175587,175587,2019,['Thriller']
4939,40,Meek's Cutoff,2000000,977772,1869928,-130072,2010,"['Drama', 'Western']"
4940,41,The Babadook,2000000,950792,7482387,5482387,2014,"['Drama', 'Horror']"
4943,44,The Virginity Hit,2000000,636706,636706,-1363294,2010,['Comedy']
4947,48,Teeth,2000000,347578,2350641,350641,2016,"['Documentary', 'History']"
4948,49,Stonewall,2000000,304602,304602,-1695398,2015,"['Drama', 'History']"
4950,51,The Last Five Years,2000000,147299,205298,-1794702,2014,"['Comedy', 'Drama', 'Musical']"
4956,57,Pump,2000000,72277,72277,-1927723,2014,['Documentary']
4959,60,Lost River,2000000,45431,2009644,9644,2014,"['Drama', 'Fantasy', 'Mystery']"
4961,62,Knock Knock,2000000,36336,6328516,4328516,2015,"['Drama', 'Thriller']"
4966,67,The First Time,2000000,17061,17061,-1982939,2012,"['Comedy', 'Drama', 'Romance']"
4968,69,Circle,2000000,10024,10024,-1989976,2010,"['Horror', 'Thriller']"
4972,73,Plush,2000000,3080,28864,-1971136,2013,"['Drama', 'Music', 'Thriller']"
4973,74,The Ghastly Love of Johnny X,2000000,2436,2436,-1997564,2012,"['Comedy', 'Fantasy', 'Musical']"
4975,76,Grave Encounters,2000000,0,2151887,151887,2011,['Horror']
4976,77,Bone Tomahawk,2000000,0,475846,-1524154,2015,"['Adventure', 'Drama', 'Horror']"
4978,79,Stitches,2000000,0,63555,-1936445,2010,['Horror']
4981,82,Nine Dead,2000000,0,0,-2000000,2010,"['Crime', 'Drama', 'Horror']"
4983,84,Rockaway,2000000,0,0,-2000000,2017,"['Adventure', 'Drama']"
4984,85,Wings,2000000,0,0,-2000000,2012,"['Adventure', 'Animation', 'Comedy']"
4986,87,Straight A's,2000000,0,0,-2000000,2013,"['Comedy', 'Drama']"
4988,89,Highway,2000000,0,0,-2000000,2012,['Comedy']
4989,90,Small Apartments,2000000,0,0,-2000000,2012,"['Comedy', 'Crime', 'Drama']"
4990,91,Coffee Town,2000000,0,0,-2000000,2013,['Comedy']
4991,92,Lucky Dog,2000000,0,0,-2000000,2012,"['Comedy', 'Crime']"
4992,93,Pendulum,2000000,0,0,-2000000,2017,['Thriller']
4995,96,The Walking Deceased,2000000,0,0,-2000000,2015,"['Comedy', 'Horror']"
4996,97,True Bromance,2000000,0,0,-2000000,2011,['Comedy']
4997,98,The Curse of Downers Grove,2000000,0,0,-2000000,2015,"['Drama', 'Horror', 'Mystery']"
4998,99,Wind Walkers,2000000,0,0,-2000000,2015,"['Action', 'Horror', 'Thriller']"
4999,100,The Dog Lover,2000000,0,0,-2000000,2016,['Drama']
5000,1,Shark Lake,2000000,0,0,-2000000,2015,"['Action', 'Adventure', 'Crime']"
5001,2,Buried,1987650,1044143,21270290,19282640,2010,"['Drama', 'Mystery', 'Thriller']"
5003,4,River's Edge,1900000,4600000,4600000,2700000,2018,['Crime']
5007,8,Brotherly Love,1900000,478595,478595,-1421405,2015,['Drama']
5008,9,Submarine,1900000,467602,4581937,2681937,2010,"['Comedy', 'Drama', 'Romance']"
5009,10,The Square,1900000,406216,740932,-1159068,2013,"['Documentary', 'Drama', 'History']"
5010,11,ABCD (Any Body Can Dance),1900000,222098,10137234,8237234,2013,"['Drama', 'Music']"
5012,13,Stranded,1900000,0,285593,-1614407,2019,"['Drama', 'Romance']"
5013,14,Vaalu,1900000,0,12444,-1887556,2015,"['Comedy', 'Romance']"
5014,15,The Last Exorcism,1800000,41034350,70165900,68365900,2010,"['Drama', 'Horror', 'Thriller']"
5017,18,Beasts of the Southern Wild,1800000,12795746,23265132,21465132,2012,"['Adventure', 'Drama', 'Fantasy']"
5024,25,Higher Ground,1800000,841056,842693,-957307,2011,['Drama']
5028,29,Deadline,1800000,0,0,-1800000,2012,"['Drama', 'Mystery', 'Thriller']"
5029,30,Sublime,1800000,0,0,-1800000,2019,['Documentary']
5030,31,Dysfunctional Friends,1800000,0,0,-1800000,2012,"['Comedy', 'Drama']"
5031,32,Independence Daysaster,1800000,0,0,-1800000,2013,"['Action', 'Adventure', 'Sci-Fi']"
5035,36,May,1750000,145540,634803,-1115197,2014,['Documentary']
5036,37,I Spit on Your Grave,1750000,93051,1278471,-471529,2010,"['Horror', 'Thriller']"
5037,38,Living Dark: The Story of Ted the Caver,1750000,0,0,-1750000,2013,['Horror']
5041,42,The Lunchbox,1700000,4231500,12231500,10531500,2013,"['Drama', 'Romance']"
5042,43,Grace Unplugged,1700000,2507159,2507159,807159,2013,"['Drama', 'Music']"
5046,47,Yes,1700000,396035,661221,-1038779,2016,"['Adventure', 'Biography', 'Documentary']"
5047,48,Braid,1660000,0,80745,-1579255,2018,"['Horror', 'Mystery', 'Thriller']"
5052,53,The Conversation,1600000,4420000,4420000,2820000,2018,['Action']
5053,54,N-Secure,1600000,2595644,2595644,995644,2010,"['Crime', 'Drama', 'Thriller']"
5055,56,Out of the Dark,1600000,419428,419428,-1180572,2014,"['Horror', 'Thriller']"
5059,60,Two Night Stand,1600000,15600,868081,-731919,2014,"['Comedy', 'Romance']"
5062,63,Insidious,1500000,54009150,99870886,98370886,2010,"['Horror', 'Mystery', 'Thriller']"
5063,64,Moonlight,1500000,27854931,65245512,63745512,2016,['Drama']
5064,65,Cabin Fever,1500000,21158188,30351664,28851664,2016,['Horror']
5065,66,Waitress,1500000,19097550,22217183,20717183,2013,['Drama']
5069,70,Unsane,1500000,7690044,14244931,12744931,2018,"['Drama', 'Horror', 'Mystery']"
5073,74,Spellbound,1500000,7000000,7000000,5500000,2011,"['Comedy', 'Horror', 'Romance']"
5076,77,The To Do List,1500000,3491669,4128828,2628828,2013,"['Comedy', 'Romance']"
5077,78,The Gatekeepers,1500000,2408553,2592308,1092308,2012,"['Documentary', 'History', 'War']"
5083,84,The Lords of Salem,1500000,1165881,1541131,41131,2012,"['Horror', 'Thriller']"
5084,85,31,1500000,779820,922727,-577273,2016,"['Horror', 'Thriller']"
5086,87,Unsullied,1500000,510957,510957,-989043,2014,"['Action', 'Horror', 'Thriller']"
5093,94,Amigo,1500000,184705,184705,-1315295,2010,"['Drama', 'War']"
5098,99,The Salon,1500000,139084,139084,-1360916,2015,['Documentary']
5101,2,Road Hard,1500000,113169,113169,-1386831,2015,['Comedy']
5106,7,Housebound,1500000,0,236863,-1263137,2014,"['Comedy', 'Horror', 'Mystery']"
5107,8,Teefa in Trouble,1500000,0,98806,-1401194,2018,"['Action', 'Comedy', 'Crime']"
5109,10,Closer to the Moon,1500000,0,5396,-1494604,2014,"['Comedy', 'Crime', 'Drama']"
5111,12,The Lion of Judah,1500000,0,0,-1500000,2011,['Animation']
5112,13,Once Upon a Time in Queens,1500000,0,0,-1500000,2013,"['Comedy', 'Drama']"
5114,15,Mutant World,1500000,0,0,-1500000,2014,['Sci-Fi']
5115,16,#Horror,1500000,0,0,-1500000,2015,"['Crime', 'Drama', 'Horror']"
5116,17,Checkmate,1500000,0,0,-1500000,2010,"['Drama', 'Mystery']"
5117,18,Snow White and the Seven Dwarfs,1488000,184925486,184925486,183437486,2017,"['Animation', 'Family']"
5120,21,Mustang,1400000,845464,5552584,4152584,2015,['Drama']
5122,23,La chambre bleue,1400000,260441,1945420,545420,2015,['Documentary']
5124,25,Eddie: The Sleepwalking Cannibal,1400000,1632,1632,-1398368,2012,"['Comedy', 'Horror']"
5125,26,My Girlfriend's Boyfriend,1400000,0,0,-1400000,2010,"['Comedy', 'Romance']"
5127,28,House at the End of the Drive,1400000,0,0,-1400000,2014,"['Horror', 'Thriller']"
5137,38,Above and Beyond,1300000,288751,288751,-1011249,2014,"['Adventure', 'Documentary', 'History']"
5142,43,Simon,1300000,4055,1738663,438663,2016,['Thriller']
5143,44,Forget Me Not,1300000,0,13465,-1286535,2010,['Romance']
5145,46,The Algerian,1300000,0,0,-1300000,2014,"['Action', 'Romance', 'Thriller']"
5146,47,Rebecca,1288000,6000000,6002370,4714370,2018,['Horror']
5150,51,Dear White People,1250000,4404154,5403771,4153771,2014,"['Comedy', 'Drama', 'Romance']"
5151,52,Filly Brown,1250000,2850357,2940411,1690411,2012,"['Drama', 'Music']"
5153,54,Bodom,1250000,0,726460,-523540,2014,"['Horror', 'Mystery', 'Thriller']"
5155,56,Da Sweet Blood of Jesus,1250000,0,0,-1250000,2014,"['Comedy', 'Romance', 'Thriller']"
5165,66,Home Run,1200000,2859955,2859955,1659955,2010,"['Drama', 'Family', 'Sport']"
5170,71,The Blue Bird,1200000,887000,887000,-313000,2015,['Drama']
5171,72,Blue Like Jazz,1200000,595018,595018,-604982,2012,"['Comedy', 'Drama']"
5173,74,Q,1200000,255000,255000,-945000,2011,['Drama']
5175,76,"Pink Ribbons, Inc.",1200000,26608,26608,-1173392,2011,['Documentary']
5176,77,Blood Feast,1200000,8708,8708,-1191292,2016,['Horror']
5182,83,Below Zero,1200000,0,0,-1200000,2011,['Thriller']
5183,84,Crowsnest,1200000,0,0,-1200000,2012,"['Horror', 'Mystery', 'Thriller']"
5184,85,Airborne,1200000,0,0,-1200000,2012,"['Comedy', 'Crime', 'Horror']"
5186,87,Bleeding Hearts,1200000,0,0,-1200000,2015,['Horror']
5187,88,The Wicked Within,1200000,0,0,-1200000,2015,['Horror']
5188,89,The Islands,1200000,0,0,-1200000,2019,['Adventure']
5199,100,Beyond the Black Rainbow,1100000,56491,56491,-1043509,2010,"['Horror', 'Sci-Fi', 'Thriller']"
5201,2,The Sleepwalker,1100000,2636,2636,-1097364,2014,['Drama']
5202,3,Departure,1100000,0,27561,-1072439,2015,"['Drama', 'Romance']"
5206,7,The Dead Undead,1100000,0,0,-1100000,2010,"['Action', 'Horror', 'Sci-Fi']"
5207,8,The Vatican Exorcisms,1100000,0,0,-1100000,2013,['Horror']
5210,11,Rocky,1000000,117235147,225000000,224000000,2013,"['Action', 'Comedy', 'Drama']"
5211,12,The Devil Inside,1000000,53262945,101759490,100759490,2012,['Horror']
5213,14,Unfriended,1000000,32789645,64364198,63364198,2014,"['Horror', 'Mystery', 'Thriller']"
5216,17,You're Next,1000000,18494006,26887177,25887177,2011,"['Action', 'Comedy', 'Horror']"
5217,18,Chernobyl Diaries,1000000,18119640,42411721,41411721,2012,"['Horror', 'Mystery', 'Thriller']"
5218,19,The Howling,1000000,17985000,17985000,16985000,2017,['Horror']
5224,25,Blue Valentine,1000000,9737892,16566240,15566240,2010,"['Drama', 'Romance']"
5228,29,Unfriended: Dark Web,1000000,8866745,16434588,15434588,2018,"['Crime', 'Horror', 'Mystery']"
5230,31,The Green Inferno,1000000,7192291,12931420,11931420,2013,"['Adventure', 'Horror']"
5231,32,I Am Not Your Negro,1000000,7123919,9617402,8617402,2016,['Documentary']
5232,33,The Sessions,1000000,6002451,11495204,10495204,2012,"['Biography', 'Comedy', 'Drama']"
5234,35,October Baby,1000000,5355847,5391992,4391992,2011,['Drama']
5235,36,The Skeleton Twins,1000000,5284309,5797192,4797192,2014,"['Comedy', 'Drama', 'Romance']"
5240,41,Obvious Child,1000000,3122616,3324070,2324070,2014,"['Comedy', 'Drama', 'Romance']"
5241,42,Martha Marcy May Marlene,1000000,2981038,5438911,4438911,2011,"['Drama', 'Mystery', 'Thriller']"
5251,52,No Man's Land,1000000,1067481,2684207,1684207,2020,['Western']
5252,53,Slam,1000000,1009819,1087521,87521,2016,"['Comedy', 'Drama', 'Romance']"
5255,56,Patti Cake$,1000000,800148,1471090,471090,2017,"['Drama', 'Music']"
5256,57,Panic,1000000,779137,1425707,425707,2014,"['Drama', 'Mystery', 'Thriller']"
5257,58,Palo Alto,1000000,767732,1156309,156309,2013,['Drama']
5261,62,The Future,1000000,568662,1239174,239174,2011,"['Drama', 'Fantasy', 'Romance']"
5263,64,23 Blast,1000000,549185,549185,-450815,2014,"['Drama', 'Family', 'Sport']"
5265,66,The Act of Killing,1000000,486919,1227316,227316,2012,"['Crime', 'Documentary']"
5269,70,I Origins,1000000,336472,852399,-147601,2014,"['Drama', 'Romance', 'Sci-Fi']"
5270,71,Antarctica: A Year on Ice,1000000,288757,288757,-711243,2013,"['Adventure', 'Biography', 'Documentary']"
5273,74,The Invitation,1000000,231738,354836,-645164,2015,"['Drama', 'Horror', 'Mystery']"
5280,81,Hardflip,1000000,96734,96734,-903266,2012,"['Action', 'Drama']"
5281,82,Creative Control,1000000,63014,63014,-936986,2015,"['Drama', 'Sci-Fi']"
5283,84,The Perfect Host,1000000,48764,51587,-948413,2010,"['Comedy', 'Crime', 'Thriller']"
5287,88,Hits,1000000,15156,15156,-984844,2014,"['Comedy', 'Drama']"
5288,89,The Specials,1000000,12996,12996,-987004,2019,['Comedy']
5291,92,Camp X-Ray,1000000,9837,101053,-898947,2014,"['Drama', 'War']"
5292,93,Special,1000000,7202,26822,-973178,2014,['Drama']
5293,94,The Sisterhood of Night,1000000,6870,6870,-993130,2014,"['Drama', 'Mystery', 'Thriller']"
5299,100,Heli,1000000,0,552614,-447386,2013,"['Crime', 'Drama', 'Romance']"
5300,1,Karachi se Lahore,1000000,0,17721,-982279,2015,"['Adventure', 'Comedy', 'Family']"
5302,3,American Hero,1000000,0,26,-999974,2012,['Music']
5305,6,The Party's Over,1000000,0,0,-1000000,2014,"['Adventure', 'Biography', 'Documentary']"
5310,11,Snow White: A Deadly Summer,1000000,0,0,-1000000,2012,['Horror']
5311,12,Truth or Die,1000000,0,0,-1000000,2012,"['Horror', 'Mystery']"
5312,13,Black Rock,1000000,0,0,-1000000,2012,"['Horror', 'Thriller']"
5313,14,Hidden Away,1000000,0,0,-1000000,2014,"['Drama', 'Romance']"
5314,15,My Last Day Without You,1000000,0,0,-1000000,2011,"['Comedy', 'Drama', 'Romance']"
5315,16,Zombie Hunter,1000000,0,0,-1000000,2013,"['Action', 'Comedy', 'Horror']"
5316,17,Doc Holliday's Revenge,1000000,0,0,-1000000,2014,['Western']
5317,18,A Fine Step,1000000,0,0,-1000000,2014,['Drama']
5318,19,Fear Clinic,1000000,0,0,-1000000,2014,['Horror']
5320,21,Bang Bang Baby,1000000,0,0,-1000000,2014,"['Drama', 'Fantasy', 'Musical']"
5321,22,Hush,1000000,0,0,-1000000,2012,"['Drama', 'Thriller']"
5322,23,1982,1000000,0,0,-1000000,2013,['Drama']
5324,25,Chemical Cut,1000000,0,0,-1000000,2016,['Drama']
5325,26,Por amor en el caserio,1000000,0,0,-1000000,2014,"['Action', 'Drama', 'Romance']"
5329,30,Banshee Chapter,950000,0,78122,-871878,2013,"['Horror', 'Sci-Fi', 'Thriller']"
5331,32,Jesse,950000,0,0,-950000,2011,"['Action', 'Crime', 'Drama']"
5332,33,Ask Me Anything,950000,0,0,-950000,2014,['Drama']
5333,34,L!fe Happens,930000,30905,30905,-899095,2011,['Comedy']
5334,35,Lowriders,916000,6179955,6188421,5272421,2016,"['Adventure', 'Crime', 'Drama']"
5335,36,Food Chains,913000,0,176,-912824,2014,['Documentary']
5337,38,Fruitvale Station,900000,16098998,17549645,16649645,2013,"['Biography', 'Drama', 'Romance']"
5338,39,Meet the Blacks,900000,9097072,9097072,8197072,2016,"['Comedy', 'Horror']"
5340,41,Circumstance,900000,454121,958978,58978,2011,['Drama']
5341,42,The Quiet,900000,381420,381420,-518580,2010,['Drama']
5342,43,The Giant Mechanical Man,900000,7396,7396,-892604,2012,"['Comedy', 'Drama', 'Romance']"
5343,44,The Brass Teapot,900000,6997,413733,-486267,2012,"['Comedy', 'Fantasy', 'Thriller']"
5344,45,40 Weeks,900000,0,0,-900000,2014,['Documentary']
5346,47,Bambi,858000,102797000,268000000,267142000,2013,"['Biography', 'Documentary']"
5349,50,The Hammer,850000,442638,442638,-407362,2010,"['Biography', 'Drama', 'Sport']"
5350,51,Windsor Drive,850000,3256,3256,-846744,2015,"['Mystery', 'Thriller']"
5368,69,Not Cool,800000,35688,35688,-764312,2014,"['Comedy', 'Drama', 'Romance']"
5369,70,Kill List,800000,29063,462206,-337794,2011,"['Crime', 'Drama', 'Horror']"
5370,71,Vessel,800000,0,0,-800000,2011,"['Drama', 'Horror']"
5374,75,Kevin Hart: Laugh at My Pain,750000,7706436,7712436,6962436,2011,"['Comedy', 'Documentary']"
5376,77,Safety Not Guaranteed,750000,4010957,4422318,3672318,2012,"['Comedy', 'Drama', 'Romance']"
5377,78,The Innkeepers,750000,78396,1011535,261535,2011,"['Drama', 'Horror', 'Mystery']"
5380,81,Undead,750000,41196,229250,-520750,2018,['Horror']
5383,84,Destiny,750000,0,450,-749550,2010,['Action']
5385,86,Adulterers,750000,0,0,-750000,2015,"['Crime', 'Drama', 'Thriller']"
5392,93,Columbus,700000,1017107,1110511,410511,2015,['Comedy']
5395,96,Walter,700000,0,0,-700000,2019,['Thriller']
5399,100,Escape from Tomorrow,650000,171962,171962,-478038,2013,"['Drama', 'Fantasy', 'Horror']"
5401,2,After,650000,0,0,-650000,2014,"['Drama', 'Mystery']"
5402,3,The Hadza: Last of the First,650000,0,0,-650000,2014,['Documentary']
5404,5,Treachery,625000,0,0,-625000,2013,"['Drama', 'Thriller']"
5411,12,Water & Power,600000,42557,42557,-557443,2013,"['Crime', 'Drama']"
5414,15,Drunk Wedding,600000,3301,3301,-596699,2015,['Comedy']
5415,16,They Will Have to Kill Us First,600000,0,7943,-592057,2015,['Documentary']
5417,18,The Maid's Room,600000,0,0,-600000,2013,['Thriller']
5418,19,Light from the Darkroom,600000,0,0,-600000,2014,"['Action', 'Drama', 'Thriller']"
5419,20,Irreplaceable,600000,0,0,-600000,2014,['Documentary']
5421,22,The Harvest/La Cosecha,560000,3709,3709,-556291,2011,['Documentary']
5422,23,Julija in alfa Romeo,560000,0,8462,-551538,2015,['Comedy']
5423,24,Mata Hari,558000,900000,900000,342000,2016,['Biography']
5425,26,Love Letters,550000,5269990,5269990,4719990,2015,['Horror']
5426,27,Faith Connections,550000,9111,9111,-540889,2013,"['Biography', 'Documentary', 'Drama']"
5427,28,High Road,546173,0,0,-546173,2011,['Comedy']
5429,30,Benji,500000,31559560,31559560,31059560,2018,"['Crime', 'Drama', 'Family']"
5436,37,Beyond the Mat,500000,2047570,2047570,1547570,2013,"['Drama', 'Sport']"
5438,39,Sholem Aleichem: Laughing in the Darkness,500000,1131261,1131261,631261,2011,['Documentary']
5440,41,Groove,500000,1115313,1167524,667524,2017,"['Drama', 'Music', 'Musical']"
5444,45,Drinking Buddies,500000,343706,407100,-92900,2013,"['Comedy', 'Drama', 'Romance']"
5446,47,Never Again,500000,307631,308793,-191207,2017,['Drama']
5449,50,Monsters,500000,237301,5639730,5139730,2010,"['Drama', 'Sci-Fi', 'Thriller']"
5451,52,Deceptive Practice: The Mysteries and Mentors of Ricky Jay,500000,152449,152449,-347551,2012,['Documentary']
5452,53,The Other Dream Team,500000,134109,314444,-185556,2012,"['Documentary', 'Sport']"
5454,55,Rubber,500000,100370,680914,180914,2010,"['Comedy', 'Fantasy', 'Horror']"
5458,59,The Journey,500000,19800,19800,-480200,2010,['Family']
5464,65,Born to Fly: Elizabeth Streb vs. Gravity,500000,1822,1822,-498178,2014,"['Action', 'Biography', 'Documentary']"
5465,66,Detention of the Dead,500000,1778,1778,-498222,2012,"['Action', 'Adventure', 'Comedy']"
5466,67,Higher Power,500000,528,528,-499472,2018,"['Action', 'Sci-Fi', 'Thriller']"
5471,72,Drones,500000,0,0,-500000,2010,['Comedy']
5472,73,Enter Nowhere,500000,0,0,-500000,2011,"['Mystery', 'Sci-Fi', 'Thriller']"
5473,74,Girls Gone Dead,500000,0,0,-500000,2012,"['Comedy', 'Horror']"
5476,77,The Outrageous Sophie Tucker,500000,0,0,-500000,2014,['Documentary']
5477,78,Subconscious,500000,0,0,-500000,2010,['Horror']
5478,79,Roadside,500000,0,0,-500000,2013,"['Drama', 'Horror', 'Mystery']"
5479,80,Diamond Ruff,500000,0,0,-500000,2015,['Action']
5480,81,Love in the Time of Monsters,500000,0,0,-500000,2014,"['Comedy', 'Horror']"
5482,83,Fight to the Finish,500000,0,0,-500000,2016,"['Action', 'Romance', 'Sport']"
5483,84,Bucky and the Squirrels,500000,0,0,-500000,2015,['Comedy']
5484,85,Going Under,500000,0,0,-500000,2011,"['Action', 'Horror', 'Thriller']"
5486,87,Alleluia! The Devil's Carnival,500000,0,0,-500000,2016,"['Horror', 'Musical']"
5488,89,The Sound and the Shadow,500000,0,0,-500000,2014,"['Comedy', 'Mystery', 'Thriller']"
5489,90,Rodeo Girl,500000,0,0,-500000,2016,"['Adventure', 'Family']"
5494,95,Brick,450000,2075743,4243996,3793996,2019,"['Drama', 'Family', 'Romance']"
5495,96,Sunday,450000,410919,450349,349,2019,['Drama']
5499,100,As It Is in Heaven,450000,13486,13486,-436514,2014,['Drama']
5500,1,Mutual Friends,450000,0,0,-450000,2013,"['Comedy', 'Romance']"
5506,7,Blue Ruin,420000,258384,437002,17002,2013,"['Crime', 'Drama', 'Thriller']"
5511,12,Heroes,400000,655538,655538,255538,2019,['Documentary']
5512,13,Tarnation,400000,592014,1162014,762014,2017,"['Comedy', 'Horror']"
5513,14,I Want Your Money,400000,433588,433588,33588,2010,['Documentary']
5515,16,Home Movies,400000,89134,89134,-310866,2011,"['Documentary', 'Family']"
5516,17,Jackpot,400000,44452,44452,-355548,2011,"['Action', 'Comedy', 'Crime']"
5522,23,Pancakes,400000,0,0,-400000,2014,['Drama']
5527,28,Maniac,350000,10000000,10000000,9650000,2011,"['Action', 'Horror', 'Thriller']"
5534,35,Rotor DR1,350000,0,0,-350000,2015,"['Family', 'Sci-Fi']"
5550,51,3 Backyards,300000,39475,39475,-260525,2010,['Drama']
5556,57,Locker 13,300000,3496,3496,-296504,2014,['Thriller']
5557,58,The Looking Glass,300000,1711,1711,-298289,2011,['Fantasy']
5558,59,All You Need Is Love,300000,0,3565259,3265259,2014,['Documentary']
5560,61,Some Guy Who Kills People,300000,0,0,-300000,2011,"['Comedy', 'Crime', 'Drama']"
5561,62,Midnight Cabaret,300000,0,0,-300000,2012,"['Action', 'Crime', 'Drama']"
5562,63,Teeth and Blood,300000,0,0,-300000,2015,"['Action', 'Horror']"
5564,65,Anderson's Cross,300000,0,0,-300000,2010,"['Comedy', 'Drama', 'Romance']"
5565,66,Amidst the Devil's Wings,300000,0,0,-300000,2014,"['Action', 'Crime', 'Drama']"
5566,67,Death Calls,290000,0,0,-290000,2010,"['Action', 'Adventure', 'Mystery']"
5567,68,Compliance,270000,319285,830700,560700,2012,"['Biography', 'Crime', 'Drama']"
5568,69,Graduation Day,250000,23894000,23894000,23644000,2015,['Thriller']
5571,72,Sleight,250000,3930990,3934450,3684450,2016,"['Action', 'Drama', 'Sci-Fi']"
5573,74,Like Crazy,250000,3395391,3728400,3478400,2011,"['Drama', 'Romance']"
5577,78,Cube,250000,489220,8969065,8719065,2013,"['Biography', 'Documentary']"
5578,79,Love and Other Catastrophes,250000,212285,743216,493216,2016,"['Comedy', 'Drama']"
5580,81,November,250000,191862,191862,-58138,2014,"['Documentary', 'History']"
5581,82,Sugar Town,250000,178095,178095,-71905,2018,"['Drama', 'Horror', 'Sci-Fi']"
5582,83,Happy Valley,250000,67665,67665,-182335,2014,"['Documentary', 'Drama', 'Sport']"
5583,84,The Canyons,250000,59671,62375,-187625,2013,"['Drama', 'Thriller']"
5588,89,Test,250000,18823,18823,-231177,2013,['Drama']
5590,91,Along the Roadside,250000,0,3234,-246766,2013,"['Comedy', 'Music', 'Romance']"
5592,93,Rust,250000,0,0,-250000,2010,['Drama']
5593,94,The Christmas Bunny,250000,0,0,-250000,2010,"['Drama', 'Family']"
5595,96,The Frozen,250000,0,0,-250000,2012,"['Drama', 'Thriller']"
5597,98,Butterfly,250000,0,0,-250000,2010,"['Horror', 'Thriller']"
5598,99,UnDivided,250000,0,0,-250000,2013,['Documentary']
5599,100,Horse Camp,250000,0,0,-250000,2017,['Family']
5600,1,Give Me Shelter,250000,0,0,-250000,2014,['Documentary']
5602,3,Shooting the Warwicks,250000,0,0,-250000,2015,"['Comedy', 'Drama']"
5604,5,Western Religion,250000,0,0,-250000,2015,"['Adventure', 'Drama', 'Fantasy']"
5609,10,Burn,225000,1109276,1109276,884276,2012,['Documentary']
5615,16,Swingers,200000,4505922,6618578,6418578,2019,['Comedy']
5617,18,The Grace Card,200000,2430735,2430735,2230735,2010,['Drama']
5620,21,The Overnight,200000,1109808,1165996,965996,2015,"['Comedy', 'Mystery']"
5622,23,Middle of Nowhere,200000,236806,236806,36806,2012,['Drama']
5625,26,Hybrid,200000,162605,162605,-37395,2013,"['Documentary', 'Sport']"
5631,32,Solitude,200000,6260,6260,-193740,2011,"['Biography', 'Documentary', 'Drama']"
5632,33,The Word,200000,3648,3648,-196352,2013,['Drama']
5637,38,Archaeology of a Woman,200000,0,0,-200000,2012,['Drama']
5638,39,Sanctuary; Quite a Conundrum,200000,0,0,-200000,2012,"['Comedy', 'Horror', 'Thriller']"
5639,40,Theresa Is a Mother,200000,0,0,-200000,2012,"['Comedy', 'Drama', 'Music']"
5640,41,Perfect Cowboy,200000,0,0,-200000,2014,['Drama']
5641,42,H.,200000,0,0,-200000,2014,"['Drama', 'Sci-Fi', 'Thriller']"
5642,43,Weekend,190000,484592,1577585,1387585,2011,"['Drama', 'Romance']"
5644,45,Butterfly Girl,180000,17503,17503,-162497,2014,['Documentary']
5647,48,Another Earth,175000,1321194,2102779,1927779,2011,"['Drama', 'Romance', 'Sci-Fi']"
5648,49,Sparrows Dance,175000,2602,2602,-172398,2012,"['Comedy', 'Drama', 'Romance']"
5649,50,Heroes of Dirt,175000,0,0,-175000,2015,"['Action', 'Drama', 'Sport']"
5650,51,The Fits,170000,166425,169242,-758,2015,"['Drama', 'Music']"
5660,61,Top Spin,150000,5858,5858,-144142,2014,['Documentary']
5661,62,Speak No Evil,150000,0,32927,-117073,2013,['Horror']
5663,64,Aroused,150000,0,0,-150000,2013,['Documentary']
5667,68,Sound of My Voice,135000,408015,429448,294448,2011,"['Drama', 'Mystery', 'Sci-Fi']"
5669,70,An American in Hollywood,125000,0,0,-125000,2014,['Drama']
5670,71,The Brain That Sings,125000,0,0,-125000,2013,"['Documentary', 'Family']"
5671,72,Romantic Schemer,125000,0,0,-125000,2015,['Romance']
5672,73,Your Sister's Sister,120000,1597486,3090593,2970593,2011,"['Comedy', 'Drama']"
5679,80,The Gallows,100000,22764410,41656474,41556474,2015,"['Horror', 'Mystery', 'Thriller']"
5685,86,A Ghost Story,100000,1594798,2769782,2669782,2017,"['Drama', 'Fantasy', 'Romance']"
5688,89,Cheap Thrills,100000,59424,59424,-40576,2013,"['Comedy', 'Crime', 'Drama']"
5689,90,The Past is a Grotesque Animal,100000,20056,20056,-79944,2014,"['Biography', 'Documentary', 'Music']"
5691,92,Indie Game: The Movie,100000,0,0,-100000,2012,"['Documentary', 'Drama']"
5693,94,Echo Dr.,100000,0,0,-100000,2013,"['Action', 'Drama', 'Sci-Fi']"
5694,95,Closure,100000,0,0,-100000,2010,['Thriller']
5696,97,Open Secret,100000,0,0,-100000,2011,['Documentary']
5697,98,The Night Visitor,100000,0,0,-100000,2013,"['Horror', 'Sci-Fi', 'Thriller']"
5698,99,Tiger Orange,100000,0,0,-100000,2014,['Drama']
5701,2,Dawn of the Crescent Moon,75000,8799,8799,-66201,2014,"['Drama', 'Sci-Fi', 'Thriller']"
5702,3,Queen Crab,75000,0,0,-75000,2015,"['Action', 'Sci-Fi', 'Thriller']"
5703,4,Happy Christmas,70000,30312,30312,-39688,2014,"['Comedy', 'Drama']"
5705,6,Absentia,70000,0,8555,-61445,2011,"['Drama', 'Horror', 'Mystery']"
5710,11,Supporting Characters,60000,4917,4917,-55083,2012,['Comedy']
5711,12,The FP,60000,0,0,-60000,2011,['Comedy']
5712,13,Hayride,60000,0,0,-60000,2012,"['Crime', 'Drama', 'Horror']"
5714,15,The Dirties,55000,0,0,-55000,2013,"['Crime', 'Drama']"
5717,18,Tiny Furniture,50000,391674,424149,374149,2010,"['Comedy', 'Drama', 'Romance']"
5719,20,Counting,50000,8374,8374,-41626,2015,['Documentary']
5721,22,Down and Dangerous,50000,0,0,-50000,2013,"['Crime', 'Thriller']"
5723,24,Bending Steel,50000,0,0,-50000,2013,['Documentary']
5724,25,"Run, Hide, Die",50000,0,0,-50000,2012,"['Horror', 'Thriller']"
5725,26,The Image Revolution,50000,0,0,-50000,2014,"['Biography', 'Documentary']"
5726,27,A True Story,45000,0,0,-45000,2013,['Comedy']
5728,29,This Is Martin Bonner,42000,0,0,-42000,2013,['Drama']
5731,32,Raymond Did It,40000,3632,3632,-36368,2011,['Horror']
5732,33,Foreign Letters,40000,0,0,-40000,2012,"['Comedy', 'Drama']"
5734,35,Her Cry: La Llorona Investigation,35000,0,0,-35000,2013,['Horror']
5735,36,Happy 40th,35000,0,0,-35000,2015,['Drama']
5737,38,Krisha,30000,144822,144822,114822,2015,['Drama']
5741,42,Paraphobia,30000,0,0,-30000,2013,"['Comedy', 'Horror', 'Thriller']"
5744,45,Emily,27000,3547,3547,-23453,2011,['Drama']
5747,48,The Terrorist,25000,195043,195043,170043,2018,['Thriller']
5748,49,Exeter,25000,0,489792,464792,2015,"['Horror', 'Mystery', 'Thriller']"
5750,51,Ten,25000,0,0,-25000,2013,['Drama']
5751,52,Dutch Kills,25000,0,0,-25000,2015,"['Crime', 'Drama', 'Thriller']"
5753,54,Dry Spell,22000,0,0,-22000,2013,"['Comedy', 'Romance']"
5755,56,All Superheroes Must Die,20000,0,0,-20000,2011,"['Sci-Fi', 'Thriller']"
5756,57,The Front Man,20000,0,0,-20000,2014,"['Biography', 'Comedy', 'Documentary']"
5758,59,The Ridges,17300,0,0,-17300,2011,"['Drama', 'Horror', 'Thriller']"
5761,62,Stories of Our Lives,15000,0,0,-15000,2014,['Drama']
5766,67,Clean,10000,138711,138711,128711,2017,"['Comedy', 'Drama', 'Horror']"
5767,68,Cure,10000,94596,94596,84596,2011,['Drama']
5772,73,Newlyweds,9000,4584,4584,-4416,2011,"['Comedy', 'Drama']"
5777,78,Red 11,7000,0,0,-7000,2019,"['Horror', 'Sci-Fi', 'Thriller']"
5780,81,A Plague So Pleasant,1400,0,0,-1400,2013,"['Drama', 'Horror', 'Thriller']"
